reference,date,amount,fee,terminal_type,terminal_id,location,net_amount
010812997,2024-10-27T10:52:52,500,0,TELEVINTI4,0009718182,,500
010813900,2024-10-27T15:06:13,1000,20,ATM,0000004103,Praia,980
010816126,2024-10-27T15:46:02,150,0,TELEVINTI4,0009865066,,150
010822069,2024-10-27T18:58:21,500,10,ATM,0000000306,Sal,490
010832648,2024-10-27T13:56:00,150,0,TELEVINTI4,0009701239,,150
010835017,2024-10-27T15:06:15,200,4,ATM,0000000601,Ribeira Grande,196
010845327,2024-10-27T18:00:54,500,0,TELEVINTI4,0009738757,,500
010853666,2024-10-27T17:48:46,200,4,ATM,0000000310,Sal,196
010858145,2024-10-27T18:27:14,510,10,ATM,0000100401,Praia,500
010858351,2024-10-27T19:34:18,500,0,TELEVINTI4,0009716379,,500
010861545,2024-10-27T14:26:02,500,0,TELEVINTI4,0009986789,,500
010861617,2024-10-27T19:34:40,150,0,TELEVINTI4,0009973337,,150
010864402,2024-10-27T11:06:55,1150,0,TELEVINTI4,0009926764,,1150
010866340,2024-10-27T10:31:35,200,4,ATM,0000000602,Sal,196
010867006,2024-10-27T14:21:51,500,10,ATM,0000120004,Sal,490
010871529,2024-10-27T21:43:44,200,4,ATM,0000000901,Sao Vicente,196
010872167,2024-10-27T02:22:42,500,10,ATM,0000000306,Sao Vicente,490
010873033,2024-10-27T19:27:12,150,0,TELEVINTI4,0009707344,,150
010875002,2024-10-27T13:58:09,500,0,TELEVINTI4,0009978338,,500
010875244,2024-10-27T17:01:02,500,0,TELEVINTI4,0009736990,,500
010875600,2024-10-27T14:46:57,150,3,ATM,0000003704,Sao Vicente,147
010876537,2024-10-27T18:51:17,1000,20,ATM,0000003703,Sao Vicente,980
010880673,2024-10-27T20:18:05,50,0,TELEVINTI4,0009564459,,50
010880840,2024-10-27T16:12:47,250,0,TELEVINTI4,0005973956,,250
010881745,2024-10-27T13:33:43,500,0,TELEVINTI4,0009999469,,500
010883122,2024-10-27T16:31:15,250,0,TELEVINTI4,0005978591,,250
010885224,2024-10-27T10:31:47,100,2,ATM,0000120002,Sal,98
010885860,2024-10-27T12:24:09,200,4,ATM,0000001810,Praia,196
010888111,2024-10-27T18:32:12,120,2,ATM,0000002301,Praia,118
010888222,2024-10-27T16:42:40,250,0,TELEVINTI4,0005867148,,250
010888899,2024-10-27T12:40:51,500,0,TELEVINTI4,0005909590,,500
010890172,2024-10-27T14:14:58,610,0,TELEVINTI4,0005988960,,610
010890590,2024-10-27T13:44:52,250,0,TELEVINTI4,0009888711,,250
010891622,2024-10-27T17:08:17,500,0,TELEVINTI4,0009588040,,500
010894978,2024-10-27T18:32:03,150,0,TELEVINTI4,0009745555,,150
010895176,2024-10-27T18:58:09,100,2,ATM,0000120002,Sal,98
010895739,2024-10-27T17:55:20,500,10,ATM,0000100301,Praia,490
010895871,2024-10-27T11:44:21,500,10,ATM,0000000305,Sal,490
010895993,2024-10-27T11:11:30,300,0,TELEVINTI4,0005997222,,300
010898886,2024-10-27T17:55:34,1000,0,TELEVINTI4,0009762291,,1000
010899290,2024-10-27T14:47:09,500,10,ATM,0000100101,Praia,490
010899540,2024-10-27T14:05:56,500,0,TELEVINTI4,0005989241,,500
010899590,2024-10-27T18:04:48,500,0,TELEVINTI4,0009867784,,500
010900213,2024-10-27T18:00:58,500,0,TELEVINTI4,0009820579,,500
010901247,2024-10-27T15:00:41,150,3,ATM,0000001814,Praia,147
010901499,2024-10-27T10:23:49,200,4,ATM,0000000401,Praia,196
010901639,2024-10-27T00:03:16,200,0,TELEVINTI4,0009524465,,200
010901692,2024-10-27T16:13:38,250,5,ATM,0000000305,Sal,245
010902090,2024-10-27T14:38:56,250,0,TELEVINTI4,0005839571,,250
010902123,2024-10-27T09:25:30,50,1,ATM,0000003703,Sao Vicente,49
010902547,2024-10-27T15:47:00,1000,0,TELEVINTI4,0009916869,,1000
010902701,2024-10-27T18:00:58,500,10,ATM,0000003801,Praia,490
010902772,2024-10-27T15:42:15,1000,0,TELEVINTI4,0009727694,,1000
010902787,2024-10-27T15:46:12,500,0,TELEVINTI4,0005806843,,500
010903049,2024-10-27T16:55:50,1000,20,ATM,0000000308,Sal,980
010903302,2024-10-27T09:43:43,250,0,TELEVINTI4,0009858562,,250
010903576,2024-10-27T12:24:17,250,0,TELEVINTI4,0005999962,,250
010903710,2024-10-27T09:25:47,700,14,ATM,0000000701,Boa Vista,686
010903940,2024-10-27T10:23:51,400,8,ATM,0000000601,Sal,392
010903967,2024-10-27T15:01:00,1000,0,TELEVINTI4,0009893012,,1000
010904743,2024-10-27T22:28:37,250,5,ATM,0000003804,Sal,245
010904803,2024-10-27T21:28:42,50,0,TELEVINTI4,0009568594,,50
010904879,2024-10-27T12:42:27,500,0,TELEVINTI4,0009720122,,500
010905055,2024-10-27T13:27:32,150,0,TELEVINTI4,0009742492,,150
010905225,2024-10-27T17:25:06,250,0,TELEVINTI4,0009961396,,250
010905241,2024-10-27T13:33:48,150,0,TELEVINTI4,0009950442,,150
010906365,2024-10-27T09:43:52,300,0,TELEVINTI4,0009911920,,300
010906512,2024-10-27T11:58:56,200,0,TELEVINTI4,0009831220,,200
010906583,2024-10-27T17:35:31,250,0,TELEVINTI4,0009949105,,250
010906813,2024-10-27T06:16:50,200,4,ATM,0000120001,Sal,196
010907020,2024-10-27T10:41:33,500,0,TELEVINTI4,0005931092,,500
010907313,2024-10-27T22:28:41,1000,20,ATM,0000000213,Sao Vicente,980
010907946,2024-10-27T17:15:50,500,0,TELEVINTI4,0009524007,,500
010907964,2024-10-27T10:54:13,500,0,TELEVINTI4,0009920862,,500
010908753,2024-10-27T11:46:23,500,0,TELEVINTI4,0009878447,,500
010909272,2024-10-27T13:12:40,250,0,TELEVINTI4,0009835369,,250
010909680,2024-10-27T19:01:06,250,0,TELEVINTI4,0005809121,,250
010909814,2024-10-27T11:45:27,150,0,TELEVINTI4,0005979641,,150
010910169,2024-10-27T15:06:33,150,0,TELEVINTI4,0009915093,,150
010910459,2024-10-27T19:49:53,250,0,TELEVINTI4,0005980476,,250
010910523,2024-10-27T00:05:05,500,10,ATM,0000000305,Sao Vicente,490
010910581,2024-10-27T23:22:24,150,0,TELEVINTI4,0005971478,,150
010910808,2024-10-27T12:42:37,500,10,ATM,0000000307,Sao Vicente,490
010910940,2024-10-27T08:54:54,200,4,ATM,0000001809,Ribeira Grande,196
010911177,2024-10-27T10:24:24,250,5,ATM,0000120002,Sal,245
010911648,2024-10-27T21:29:15,200,4,ATM,0000000310,Sal,196
010911931,2024-10-27T12:24:38,500,0,TELEVINTI4,0009752243,,500
010912275,2024-10-27T19:13:41,250,0,TELEVINTI4,0009100147,,250
010912467,2024-10-27T16:46:11,150,0,TELEVINTI4,0005945724,,150
010912604,2024-10-27T14:16:02,65,0,TELEVINTI4,0009877084,,65
010912624,2024-10-27T18:23:14,190,0,TELEVINTI4,0009540459,,190
010912693,2024-10-27T18:22:46,100,0,TELEVINTI4,0009253072,,100
010912782,2024-10-27T18:33:37,1000,20,ATM,0000000701,Sal,980
010912996,2024-10-27T18:16:08,500,0,TELEVINTI4,0005966904,,500
010913646,2024-10-27T18:47:28,500,10,ATM,0000559411,Praia,490
010913740,2024-10-27T11:26:28,1000,20,ATM,0000000503,Tarrafal,980
010913895,2024-10-27T16:20:20,500,10,ATM,0000000503,Tarrafal,490
010914285,2024-10-27T10:13:55,250,0,TELEVINTI4,0009924159,,250
010914311,2024-10-27T15:20:10,1000,20,ATM,0000110202,Sao Vicente,980
010914663,2024-10-27T11:19:53,1000,0,TELEVINTI4,0005969607,,1000
010914919,2024-10-27T15:47:07,1000,20,ATM,0000004705,Praia,980
010915109,2024-10-27T14:09:12,1000,0,TELEVINTI4,0009972247,,1000
010915575,2024-10-27T16:42:54,1000,20,ATM,0000003703,Sao Vicente,980
010915743,2024-10-27T13:15:03,150,0,TELEVINTI4,0005993680,,150
010915877,2024-10-27T10:14:11,150,0,TELEVINTI4,0009588773,,150
010916059,2024-10-27T09:32:50,250,0,TELEVINTI4,0009843201,,250
010916866,2024-10-27T13:56:19,500,0,TELEVINTI4,0005857585,,500
010917062,2024-10-27T00:40:55,70,0,TELEVINTI4,0009878557,,70
010917242,2024-10-27T14:47:55,350,7,ATM,0000003704,Sao Vicente,343
010917542,2024-10-27T12:09:51,1000,0,TELEVINTI4,0005937022,,1000
010917742,2024-10-27T18:01:18,1000,20,ATM,0000001003,Praia,980
010918055,2024-10-27T17:01:37,1000,20,ATM,0000000310,Sal,980
010918275,2024-10-27T12:51:57,150,3,ATM,0000001902,Ribeira Brava,147
010918695,2024-10-27T16:51:26,200,0,TELEVINTI4,0009801255,,200
010918766,2024-10-27T22:28:48,500,0,TELEVINTI4,0009804557,,500
010918960,2024-10-27T09:44:36,250,0,TELEVINTI4,0009963481,,250
010919170,2024-10-27T14:39:23,1000,20,ATM,0000001501,Sal,980
010919899,2024-10-27T15:02:16,1000,20,ATM,0000100106,Praia,980
010919926,2024-10-27T10:54:21,150,0,TELEVINTI4,0005938297,,150
010920614,2024-10-27T17:41:39,250,0,TELEVINTI4,0009707289,,250
010920668,2024-10-27T10:42:18,100,0,TELEVINTI4,0009866148,,100
010920700,2024-10-27T11:06:57,200,4,ATM,0000001902,Ribeira Brava,196
010920746,2024-10-27T17:41:33,500,10,ATM,0000000503,Boa Vista,490
010920883,2024-10-27T20:19:53,250,0,TELEVINTI4,0009728826,,250
010920972,2024-10-27T17:01:47,300,6,ATM,0000000115,Praia,294
010921235,2024-10-27T20:07:25,250,0,TELEVINTI4,0009523215,,250
010921479,2024-10-27T12:42:54,50,0,TELEVINTI4,0009780050,,50
010921682,2024-10-27T13:00:03,500,0,TELEVINTI4,0009856648,,500
010922002,2024-10-27T12:00:45,250,5,ATM,0000004003,Tarrafal de Sao,245
010922079,2024-10-27T18:52:20,250,0,TELEVINTI4,0005948747,,250
010922305,2024-10-27T20:06:40,200,0,TELEVINTI4,0009563402,,200
010922349,2024-10-27T18:52:18,200,0,TELEVINTI4,0009958169,,200
010922366,2024-10-27T19:56:40,500,0,TELEVINTI4,0009516391,,500
010922911,2024-10-27T12:03:25,500,0,TELEVINTI4,0005857188,,500
010922985,2024-10-27T18:05:23,1000,20,ATM,0000001814,Praia,980
010923585,2024-10-27T15:35:47,100,0,TELEVINTI4,0009763768,,100
010923695,2024-10-27T10:18:08,250,0,TELEVINTI4,0005941387,,250
010923819,2024-10-27T18:01:54,200,4,ATM,0000000501,Sal,196
010923908,2024-10-27T20:41:28,1000,0,TELEVINTI4,0009516884,,1000
010923954,2024-10-27T19:50:03,200,0,TELEVINTI4,0009870610,,200
010924004,2024-10-27T13:38:43,111,0,TELEVINTI4,0009959677,,111
010924024,2024-10-27T12:04:19,250,0,TELEVINTI4,0009577705,,250
010924334,2024-10-27T14:31:30,1500,30,ATM,0000001810,Praia,1470
010924346,2024-10-27T13:38:59,250,0,TELEVINTI4,0009950394,,250
010924423,2024-10-27T14:31:23,1000,0,TELEVINTI4,0005950387,,1000
010924930,2024-10-27T02:29:00,200,4,ATM,0000000906,Sao Vicente,196
010924935,2024-10-27T17:16:03,150,0,TELEVINTI4,0009991282,,150
010925211,2024-10-27T11:07:05,200,4,ATM,0000004103,Praia,196
010925348,2024-10-27T11:56:10,250,0,TELEVINTI4,0009968768,,250
010925474,2024-10-27T13:04:01,250,5,ATM,0000000802,Ribeira Grande,245
010925736,2024-10-27T18:23:41,700,0,TELEVINTI4,0009823379,,700
010925896,2024-10-27T13:15:19,500,0,TELEVINTI4,0009951345,,500
010926129,2024-10-27T06:21:04,500,10,ATM,0000003201,Tarrafal de Sao,490
010926408,2024-10-27T11:56:12,150,0,TELEVINTI4,0005958031,,150
010926457,2024-10-27T16:26:02,1000,0,TELEVINTI4,0009843127,,1000
010926519,2024-10-27T19:28:27,150,0,TELEVINTI4,0009362134,,150
010926764,2024-10-27T08:55:52,250,0,TELEVINTI4,0009873728,,250
010926787,2024-10-27T13:45:46,300,0,TELEVINTI4,0009813733,,300
010926866,2024-10-27T20:42:53,300,6,ATM,0000003303,Sao Vicente,294
010926889,2024-10-27T11:36:29,1000,20,ATM,0000120203,Sal,980
010926968,2024-10-27T18:52:38,50,0,TELEVINTI4,0009513640,,50
010927035,2024-10-27T01:09:41,500,0,TELEVINTI4,0009833092,,500
010927284,2024-10-27T09:33:32,100,0,TELEVINTI4,0005962642,,100
010927327,2024-10-27T16:31:53,1000,20,ATM,0000000306,Sal,980
010927332,2024-10-27T18:48:10,250,5,ATM,0000000802,Ribeira Grande,245
010927423,2024-10-27T12:10:49,500,0,TELEVINTI4,0009923728,,500
010927425,2024-10-27T09:26:01,250,0,TELEVINTI4,0005893787,,250
010927431,2024-10-27T18:24:00,300,6,ATM,0000000407,Praia,294
010927497,2024-10-27T02:30:03,200,4,ATM,0000000906,Sao Vicente,196
010927965,2024-10-27T18:52:44,500,0,TELEVINTI4,0005910167,,500
010927986,2024-10-27T18:52:43,1000,0,TELEVINTI4,0009922597,,1000
010927989,2024-10-27T16:09:11,610,12,ATM,0000000604,Santa Catarina,598
010928338,2024-10-27T10:39:00,250,0,TELEVINTI4,0009918604,,250
010928402,2024-10-27T14:42:17,4000,0,TELEVINTI4,0009840018,,4000
010928549,2024-10-27T14:48:17,1000,20,ATM,0000000305,Sao Vicente,980
010928676,2024-10-27T18:12:03,300,0,TELEVINTI4,0009872477,,300
010928794,2024-10-27T10:18:30,500,10,ATM,0000003106,Maio,490
010928813,2024-10-27T13:23:37,300,6,ATM,0000001406,Praia,294
010928897,2024-10-27T08:27:15,1000,20,ATM,0000000704,Porto Novo,980
010928908,2024-10-27T09:08:40,250,5,ATM,0000000305,Sal,245
010928942,2024-10-27T20:20:53,250,0,TELEVINTI4,0009719311,,250
010928954,2024-10-27T11:20:00,500,10,ATM,0000000305,Sal,490
010929162,2024-10-27T10:32:56,1000,20,ATM,0000001804,Tarrafal,980
010929280,2024-10-27T11:47:32,500,0,TELEVINTI4,0009815146,,500
010929556,2024-10-27T17:01:57,500,0,TELEVINTI4,0009589375,,500
010929793,2024-10-27T10:55:20,150,0,TELEVINTI4,0009522292,,150
010930265,2024-10-27T14:31:39,500,0,TELEVINTI4,0005948837,,500
010930304,2024-10-27T00:41:03,500,0,TELEVINTI4,0009575676,,500
010930558,2024-10-27T16:46:16,130,3,ATM,0000002201,Praia,127
010931040,2024-10-27T17:42:03,250,0,TELEVINTI4,0005964679,,250
010931077,2024-10-27T17:56:55,250,5,ATM,0000000401,Sao Filipe,245
010931340,2024-10-27T17:41:46,300,6,ATM,0000000501,Sal,294
010931668,2024-10-27T18:58:27,200,0,TELEVINTI4,0009993463,,200
010931781,2024-10-27T17:36:18,150,0,TELEVINTI4,0009950883,,150
010931926,2024-10-27T20:21:32,200,0,TELEVINTI4,0005860082,,200
010932110,2024-10-27T12:04:45,100,2,ATM,0000000203,Sao Vicente,98
010932276,2024-10-27T21:11:36,250,0,TELEVINTI4,0009884573,,250
010932481,2024-10-27T06:22:41,500,10,ATM,0000001305,Praia,490
010932569,2024-10-27T19:35:15,500,0,TELEVINTI4,0005815518,,500
010932626,2024-10-27T20:08:07,150,0,TELEVINTI4,0005979705,,150
010932691,2024-10-27T20:43:18,1000,0,TELEVINTI4,0009934067,,1000
010932912,2024-10-27T16:57:15,150,0,TELEVINTI4,0005896062,,150
010933028,2024-10-27T18:12:19,500,10,ATM,0000120002,Sal,490
010933029,2024-10-27T11:37:15,500,10,ATM,0000100107,Praia,490
010933073,2024-10-27T13:15:27,500,10,ATM,0000001006,Praia,490
010933080,2024-10-27T15:10:55,100,0,TELEVINTI4,0005886305,,100
010933082,2024-10-27T17:42:22,300,6,ATM,0000003801,Praia,294
010933091,2024-10-27T09:21:19,500,10,ATM,0000001006,Praia,490
010933151,2024-10-27T09:21:41,500,0,TELEVINTI4,0009853954,,500
010933176,2024-10-27T16:18:11,200,4,ATM,0000002901,Maio,196
010933333,2024-10-27T18:34:27,460,0,TELEVINTI4,0009812253,,460
010933416,2024-10-27T18:48:15,500,10,ATM,0000559411,Praia,490
010933558,2024-10-27T13:05:56,250,0,TELEVINTI4,0009887887,,250
010933560,2024-10-27T13:27:42,500,10,ATM,0000001001,Praia,490
010933585,2024-10-27T13:12:53,250,0,TELEVINTI4,0005896062,,250
010933674,2024-10-27T12:00:17,500,0,TELEVINTI4,0009917016,,500
010933695,2024-10-27T08:56:50,300,6,ATM,0000000310,Sal,294
010933766,2024-10-27T17:20:14,73,0,TELEVINTI4,0009776850,,73
010933993,2024-10-27T10:55:35,300,6,ATM,0000000310,Sal,294
010934026,2024-10-27T09:46:46,150,0,TELEVINTI4,0005964628,,150
010934049,2024-10-27T07:11:01,500,0,TELEVINTI4,0009577473,,500
010934070,2024-10-27T20:43:37,300,6,ATM,0000003703,Sao Vicente,294
010934242,2024-10-27T08:56:48,300,0,TELEVINTI4,0009917454,,300
010934273,2024-10-27T17:56:59,700,14,ATM,0000001814,Praia,686
010934283,2024-10-27T20:08:12,500,0,TELEVINTI4,0009803630,,500
010934483,2024-10-27T10:42:33,150,3,ATM,0000000901,Sao Vicente,147
010934570,2024-10-27T10:02:11,1000,0,TELEVINTI4,0009762590,,1000
010934595,2024-10-27T13:56:31,500,0,TELEVINTI4,0009824143,,500
010934655,2024-10-27T20:43:44,500,0,TELEVINTI4,0009796164,,500
010935060,2024-10-27T16:57:21,100,0,TELEVINTI4,0005899801,,100
010935164,2024-10-27T10:15:36,50,0,TELEVINTI4,0005971152,,50
010935217,2024-10-27T12:05:16,50,0,TELEVINTI4,0009577705,,50
010935582,2024-10-27T11:48:47,60,0,TELEVINTI4,0009751623,,60
010935599,2024-10-27T17:20:33,250,0,TELEVINTI4,0009869580,,250
010935720,2024-10-27T10:16:07,150,3,ATM,0000003407,Praia,147
010935733,2024-10-27T20:57:34,60,1,ATM,0000000305,Sal,59
010935812,2024-10-27T19:01:37,1000,0,TELEVINTI4,0009738317,,1000
010935862,2024-10-27T15:27:53,250,0,TELEVINTI4,0009568594,,250
010935896,2024-10-27T22:29:07,500,0,TELEVINTI4,0009971981,,500
010935908,2024-10-27T11:00:49,500,10,ATM,0000002901,Maio,490
010935973,2024-10-27T12:19:18,200,4,ATM,0000003902,Mosteiros,196
010935977,2024-10-27T17:36:37,150,3,ATM,0000000107,Sao Vicente,147
010935984,2024-10-27T13:41:38,150,0,TELEVINTI4,0009544038,,150
010935996,2024-10-27T10:16:08,150,3,ATM,0000001103,Sao Filipe,147
010936661,2024-10-27T18:39:24,650,0,TELEVINTI4,0005938172,,650
010936709,2024-10-27T13:29:40,500,0,TELEVINTI4,0009912033,,500
010936939,2024-10-27T20:08:37,150,0,TELEVINTI4,0005911256,,150
010937182,2024-10-27T17:21:16,500,0,TELEVINTI4,0009976049,,500
010937210,2024-10-27T10:42:34,600,0,TELEVINTI4,0009925054,,600
010937237,2024-10-27T13:15:35,500,0,TELEVINTI4,0009848826,,500
010937340,2024-10-27T14:06:00,200,0,TELEVINTI4,0009865373,,200
010937348,2024-10-27T11:20:08,500,0,TELEVINTI4,0005999626,,500
010937390,2024-10-27T21:12:17,150,0,TELEVINTI4,0009511023,,150
010937394,2024-10-27T11:38:38,150,0,TELEVINTI4,0009774506,,150
010937505,2024-10-27T15:10:57,1000,20,ATM,0000000308,Sal,980
010937560,2024-10-27T13:29:05,150,0,TELEVINTI4,0009531433,,150
010937692,2024-10-27T21:11:58,150,0,TELEVINTI4,0009978338,,150
010937755,2024-10-27T15:02:41,100,0,TELEVINTI4,0009774486,,100
010938128,2024-10-27T13:58:52,1000,0,TELEVINTI4,0009825232,,1000
010938297,2024-10-27T12:52:09,200,4,ATM,0000000904,Sao Vicente,196
010938489,2024-10-27T14:42:42,300,0,TELEVINTI4,0009917352,,300
010938541,2024-10-27T08:58:04,400,0,TELEVINTI4,0009822339,,400
010938594,2024-10-27T16:43:32,200,4,ATM,0000000803,Praia,196
010938601,2024-10-27T11:39:02,500,10,ATM,0000003206,Sao Miguel,490
010939210,2024-10-27T16:10:22,500,10,ATM,0000000503,Boa Vista,490
010939304,2024-10-27T18:34:38,300,6,ATM,0000000601,Sal,294
010939378,2024-10-27T20:08:51,1000,0,TELEVINTI4,0005844431,,1000
010939621,2024-10-27T18:53:23,500,0,TELEVINTI4,0009912957,,500
010939742,2024-10-27T18:08:00,250,5,ATM,0000000904,Sao Vicente,245
010939894,2024-10-27T09:26:24,150,0,TELEVINTI4,0005925439,,150
010939900,2024-10-27T11:20:09,500,0,TELEVINTI4,0005890109,,500
010939964,2024-10-27T16:20:45,1000,0,TELEVINTI4,0009599302,,1000
010940075,2024-10-27T16:32:38,1000,0,TELEVINTI4,0009946125,,1000
010940130,2024-10-27T09:48:57,200,4,ATM,0000000504,Sal,196
010940181,2024-10-27T13:15:41,250,0,TELEVINTI4,0009767204,,250
010940289,2024-10-27T14:22:26,50,0,TELEVINTI4,0005824982,,50
010940384,2024-10-27T15:28:24,1000,0,TELEVINTI4,0005998361,,1000
010940495,2024-10-27T12:25:40,1000,20,ATM,0000000306,Sal,980
010940553,2024-10-27T06:25:38,500,0,TELEVINTI4,0009727414,,500
010940562,2024-10-27T00:14:08,250,5,ATM,0000000601,Sal,245
010940668,2024-10-27T11:32:11,500,0,TELEVINTI4,0009725819,,500
010940781,2024-10-27T13:16:10,150,0,TELEVINTI4,0009712407,,150
010940846,2024-10-27T21:45:34,50,0,TELEVINTI4,0009361368,,50
010940962,2024-10-27T14:31:49,251,0,TELEVINTI4,0005931725,,251
010940997,2024-10-27T12:53:59,150,0,TELEVINTI4,0009275713,,150
010941025,2024-10-27T15:28:38,300,0,TELEVINTI4,0009817376,,300
010941107,2024-10-27T08:41:09,450,9,ATM,0000000115,Praia,441
010941184,2024-10-27T17:09:18,150,0,TELEVINTI4,0009941993,,150
010941217,2024-10-27T12:25:13,110,0,TELEVINTI4,0005979641,,110
010941285,2024-10-27T17:21:33,160,0,TELEVINTI4,0005836927,,160
010941300,2024-10-27T18:36:52,200,0,TELEVINTI4,0009993989,,200
010941321,2024-10-27T07:52:09,50,0,TELEVINTI4,0009727414,,50
010941329,2024-10-27T10:25:23,1000,0,TELEVINTI4,0009867465,,1000
010941336,2024-10-27T13:34:41,1000,20,ATM,0000003303,Sao Vicente,980
010941445,2024-10-27T12:25:34,200,4,ATM,0000001405,Praia,196
010941455,2024-10-27T08:28:03,700,0,TELEVINTI4,0009982691,,700
010941462,2024-10-27T13:01:07,200,0,TELEVINTI4,0009919569,,200
010941465,2024-10-27T11:39:25,250,0,TELEVINTI4,0009732735,,250
010941479,2024-10-27T22:12:21,300,0,TELEVINTI4,0009521428,,300
010941480,2024-10-27T10:44:10,150,0,TELEVINTI4,0009979264,,150
010941587,2024-10-27T17:10:27,2000,0,TELEVINTI4,0009924424,,2000
010941743,2024-10-27T14:54:43,150,0,TELEVINTI4,0005998547,,150
010941819,2024-10-27T13:59:11,300,0,TELEVINTI4,0009241669,,300
010941900,2024-10-27T18:37:05,200,0,TELEVINTI4,0009164278,,200
010941974,2024-10-27T14:48:48,300,6,ATM,0000000401,Sao Filipe,294
010942020,2024-10-27T10:55:47,110,0,TELEVINTI4,0005938297,,110
010942096,2024-10-27T21:32:10,100,0,TELEVINTI4,0009568594,,100
010942104,2024-10-27T07:53:30,500,0,TELEVINTI4,0005804969,,500
010942105,2024-10-27T14:49:16,250,5,ATM,0000003704,Sao Vicente,245
010942127,2024-10-27T14:10:05,110,2,ATM,0000000306,Sal,108
010942150,2024-10-27T08:28:14,500,10,ATM,0000000605,Santa Catarina,490
010942152,2024-10-27T14:29:17,300,0,TELEVINTI4,0009923643,,300
010942222,2024-10-27T20:10:22,200,4,ATM,0000003804,Sal,196
010942273,2024-10-27T20:44:10,300,0,TELEVINTI4,0009833309,,300
010942283,2024-10-27T20:44:05,500,10,ATM,0000000501,Sal,490
010942284,2024-10-27T20:43:57,150,0,TELEVINTI4,0005995252,,150
010942354,2024-10-27T19:36:15,500,0,TELEVINTI4,0009218145,,500
010942402,2024-10-27T08:41:35,150,0,TELEVINTI4,0009998795,,150
010942416,2024-10-27T16:52:05,200,0,TELEVINTI4,0005854793,,200
010942473,2024-10-27T13:30:19,500,10,ATM,0000100111,Praia,490
010942504,2024-10-27T16:48:37,200,0,TELEVINTI4,0009129676,,200
010942539,2024-10-27T17:26:57,250,0,TELEVINTI4,0005952892,,250
010942648,2024-10-27T13:57:11,300,6,ATM,0000559407,Praia,294
010942804,2024-10-27T20:10:42,550,0,TELEVINTI4,0005920918,,550
010942828,2024-10-27T13:46:23,200,4,ATM,0000003504,Praia,196
010942871,2024-10-27T16:26:42,250,0,TELEVINTI4,0009886435,,250
010942983,2024-10-27T16:47:15,490,10,ATM,0000000506,Sal,480
010942991,2024-10-27T10:09:56,500,0,TELEVINTI4,0009976613,,500
010943065,2024-10-27T16:47:05,300,0,TELEVINTI4,0009934202,,300
010943117,2024-10-27T17:57:49,250,0,TELEVINTI4,0009578132,,250
010943121,2024-10-27T14:29:23,550,0,TELEVINTI4,0005938528,,550
010943243,2024-10-27T22:13:46,500,10,ATM,0000120004,Sal,490
010943341,2024-10-27T14:17:07,150,0,TELEVINTI4,0009774713,,150
010943359,2024-10-27T13:24:06,1000,0,TELEVINTI4,0009131020,,1000
010943432,2024-10-27T08:49:00,500,10,ATM,0000001405,Praia,490
010943618,2024-10-27T12:01:00,1000,0,TELEVINTI4,0009934350,,1000
010943650,2024-10-27T01:23:00,50,0,TELEVINTI4,0005854146,,50
010943696,2024-10-27T08:08:20,200,0,TELEVINTI4,0009229702,,200
010943804,2024-10-27T15:12:02,500,0,TELEVINTI4,0009944188,,500
010943911,2024-10-27T14:31:59,1000,20,ATM,0000000802,Ribeira Grande,980
010944280,2024-10-27T19:36:28,200,4,ATM,0000000802,Ribeira Grande,196
010944325,2024-10-27T12:26:26,150,0,TELEVINTI4,0009971875,,150
010944380,2024-10-27T18:48:35,1000,20,ATM,0000120004,Sal,980
010944399,2024-10-27T13:13:00,500,0,TELEVINTI4,0005976418,,500
010944511,2024-10-27T22:12:46,500,0,TELEVINTI4,0009859313,,500
010944521,2024-10-27T18:59:52,500,0,TELEVINTI4,0009542201,,500
010944647,2024-10-27T08:07:54,500,0,TELEVINTI4,0009361810,,500
010944717,2024-10-27T17:10:49,1000,20,ATM,0000000115,Praia,980
010944812,2024-10-27T12:05:41,91,0,TELEVINTI4,0009599271,,91
010945043,2024-10-27T12:01:41,300,6,ATM,0000003902,Mosteiros,294
010945066,2024-10-27T12:44:54,500,10,ATM,0000120002,Sal,490
010945164,2024-10-27T19:37:40,250,0,TELEVINTI4,0009988168,,250
010945167,2024-10-27T00:16:25,50,0,TELEVINTI4,0009938022,,50
010945291,2024-10-27T12:44:52,300,6,ATM,0000000207,Sao Vicente,294
010945333,2024-10-27T14:10:43,500,0,TELEVINTI4,0005873362,,500
010945356,2024-10-27T13:59:52,1000,0,TELEVINTI4,0009597566,,1000
010945383,2024-10-27T16:43:48,250,0,TELEVINTI4,0009726422,,250
010945398,2024-10-27T15:20:45,500,0,TELEVINTI4,0005886305,,500
010945514,2024-10-27T16:52:30,500,0,TELEVINTI4,0009582984,,500
010945541,2024-10-27T18:40:25,500,0,TELEVINTI4,0009922349,,500
010945607,2024-10-27T14:22:52,500,10,ATM,0000120004,Sal,490
010945648,2024-10-27T14:42:57,1000,0,TELEVINTI4,0009818300,,1000
010945658,2024-10-27T09:26:44,50,1,ATM,0000000401,Santa Catarina,49
010945695,2024-10-27T15:47:53,1000,0,TELEVINTI4,0005869111,,1000
010945720,2024-10-27T11:15:17,200,0,TELEVINTI4,0005948747,,200
010945772,2024-10-27T03:03:43,250,5,ATM,0000000107,Sao Vicente,245
010945802,2024-10-27T18:16:20,100,2,ATM,0000000803,Praia,98
010945806,2024-10-27T18:24:48,250,0,TELEVINTI4,0005953134,,250
010945810,2024-10-27T17:10:41,1500,0,TELEVINTI4,0009915620,,1500
010945814,2024-10-27T18:40:51,200,0,TELEVINTI4,0009715866,,200
010945830,2024-10-27T17:11:07,500,10,ATM,0000005303,Santa Catarina,490
010945945,2024-10-27T19:37:06,500,0,TELEVINTI4,0009916604,,500
010945972,2024-10-27T06:35:15,250,0,TELEVINTI4,0005812680,,250
010946043,2024-10-27T14:22:49,300,0,TELEVINTI4,0009824738,,300
010946069,2024-10-27T14:11:09,500,0,TELEVINTI4,0009777028,,500
010946071,2024-10-27T16:04:08,250,0,TELEVINTI4,0009547172,,250
010946143,2024-10-27T11:21:10,250,5,ATM,0000001802,Maio,245
010946153,2024-10-27T14:42:45,500,0,TELEVINTI4,0005997577,,500
010946168,2024-10-27T00:15:53,500,10,ATM,0000120002,Sal,490
010946174,2024-10-27T16:34:25,200,4,ATM,0000130001,Santa Catarina,196
010946300,2024-10-27T09:00:42,150,0,TELEVINTI4,0009949648,,150
010946310,2024-10-27T18:49:07,600,0,TELEVINTI4,0009828927,,600
010946354,2024-10-27T12:20:13,1500,0,TELEVINTI4,0005943685,,1500
010946437,2024-10-27T17:11:16,250,0,TELEVINTI4,0005934448,,250
010946451,2024-10-27T21:35:34,250,0,TELEVINTI4,0005959195,,250
010946491,2024-10-27T15:21:48,1000,20,ATM,0000002701,Sao Filipe,980
010946519,2024-10-27T09:22:45,500,10,ATM,0000000803,Praia,490
010946547,2024-10-27T18:28:34,300,6,ATM,0000001802,Maio,294
010946611,2024-10-27T09:27:33,1000,20,ATM,0000002905,Boa Vista,980
010946676,2024-10-27T11:49:55,250,0,TELEVINTI4,0005937550,,250
010946752,2024-10-27T16:50:01,1000,20,ATM,0000001103,Sao Filipe,980
010946759,2024-10-27T18:54:07,150,3,ATM,0000000108,Praia,147
010946829,2024-10-27T14:11:29,250,0,TELEVINTI4,0005873362,,250
010946896,2024-10-27T13:01:18,500,0,TELEVINTI4,0009773077,,500
010946983,2024-10-27T10:45:43,350,0,TELEVINTI4,0009791959,,350
010946990,2024-10-27T13:16:16,300,6,ATM,0000011301,Sal,294
010946998,2024-10-27T10:39:38,1000,0,TELEVINTI4,0009842514,,1000
010947059,2024-10-27T10:45:33,250,0,TELEVINTI4,0009570364,,250
010947091,2024-10-27T13:17:09,150,3,ATM,0000000902,Praia,147
010947104,2024-10-27T16:18:24,150,0,TELEVINTI4,0005918801,,150
010947190,2024-10-27T15:22:19,150,0,TELEVINTI4,0009967508,,150
010947196,2024-10-27T14:39:33,700,0,TELEVINTI4,0009833087,,700
010947310,2024-10-27T07:18:51,500,10,ATM,0000001809,Ribeira Grande,490
010947361,2024-10-27T13:17:02,500,0,TELEVINTI4,0009772282,,500
010947364,2024-10-27T18:49:16,250,0,TELEVINTI4,0009567072,,250
010947424,2024-10-27T11:02:24,500,0,TELEVINTI4,0009777664,,500
010947488,2024-10-27T16:26:42,1000,0,TELEVINTI4,0009513640,,1000
010947532,2024-10-27T12:06:02,1000,0,TELEVINTI4,0005843816,,1000
010947549,2024-10-27T10:34:04,250,0,TELEVINTI4,0009962638,,250
010947582,2024-10-27T13:17:40,500,0,TELEVINTI4,0009531629,,500
010947586,2024-10-27T13:30:36,1000,20,ATM,0000003606,Sao Vicente,980
010947642,2024-10-27T13:30:42,500,10,ATM,0000003504,Praia,490
010947685,2024-10-27T15:56:37,100,0,TELEVINTI4,0009531629,,100
010947745,2024-10-27T14:11:33,500,0,TELEVINTI4,0005826146,,500
010947804,2024-10-27T15:43:04,250,0,TELEVINTI4,0005949868,,250
010947819,2024-10-27T13:06:11,150,3,ATM,0000002701,Sao Filipe,147
010947837,2024-10-27T11:40:48,50,0,TELEVINTI4,0009892331,,50
010947867,2024-10-27T11:50:20,200,4,ATM,0000003902,Mosteiros,196
010947889,2024-10-27T10:56:19,1000,20,ATM,0000100106,Praia,980
010947931,2024-10-27T13:06:50,500,10,ATM,0000000403,Santa Catarina,490
010947939,2024-10-27T15:57:48,1000,0,TELEVINTI4,0005947119,,1000
010947977,2024-10-27T17:11:20,50,0,TELEVINTI4,0005925439,,50
010947996,2024-10-27T00:45:57,250,0,TELEVINTI4,0009717943,,250
010948001,2024-10-27T12:06:23,100,2,ATM,0000000203,Sao Vicente,98
010948002,2024-10-27T10:16:45,150,0,TELEVINTI4,0005946789,,150
010948008,2024-10-27T16:10:50,500,0,TELEVINTI4,0009995335,,500
010948045,2024-10-27T14:51:21,1000,20,ATM,0000004705,Praia,980
010948264,2024-10-27T20:58:29,1000,0,TELEVINTI4,0005930571,,1000
010948283,2024-10-27T11:50:43,500,0,TELEVINTI4,0009815547,,500
010948334,2024-10-27T14:49:49,120,0,TELEVINTI4,0009828643,,120
010948351,2024-10-27T18:08:50,500,0,TELEVINTI4,0009937114,,500
010948354,2024-10-27T06:36:20,200,4,ATM,0000000203,Sao Vicente,196
010948370,2024-10-27T00:41:41,166,0,TELEVINTI4,0009878557,,166
010948380,2024-10-27T18:09:27,1150,23,ATM,0000007203,Praia,1127
010948428,2024-10-27T14:22:59,250,0,TELEVINTI4,0009886435,,250
010948429,2024-10-27T16:10:51,1000,0,TELEVINTI4,0005924348,,1000
010948443,2024-10-27T01:26:48,150,0,TELEVINTI4,0009824472,,150
010948526,2024-10-27T14:55:12,100,0,TELEVINTI4,0009500217,,100
010948567,2024-10-27T15:48:31,150,0,TELEVINTI4,0005948550,,150
010948591,2024-10-27T15:48:21,100,0,TELEVINTI4,0009750436,,100
010948642,2024-10-27T01:40:11,500,0,TELEVINTI4,0005999041,,500
010948644,2024-10-27T14:12:17,100,0,TELEVINTI4,0005980973,,100
010948716,2024-10-27T20:58:39,500,0,TELEVINTI4,0009824143,,500
010948820,2024-10-27T20:22:09,500,0,TELEVINTI4,0005860082,,500
010948880,2024-10-27T15:23:04,150,0,TELEVINTI4,0009967508,,150
010948895,2024-10-27T19:51:12,120,0,TELEVINTI4,0005822010,,120
010948899,2024-10-27T15:49:08,1000,0,TELEVINTI4,0009830097,,1000
010948916,2024-10-27T18:42:24,1500,0,TELEVINTI4,0009828471,,1500
010948943,2024-10-27T11:29:18,1050,0,TELEVINTI4,0009705601,,1050
010948948,2024-10-27T16:53:39,150,0,TELEVINTI4,0009828613,,150
010948999,2024-10-27T11:33:13,260,5,ATM,0000000307,Sal,255
010949078,2024-10-27T14:51:33,500,10,ATM,0000001406,Praia,490
010949111,2024-10-27T14:00:07,1000,20,ATM,0000000503,Tarrafal,980
010949153,2024-10-27T17:53:31,1000,20,ATM,0000011301,Sal,980
010949167,2024-10-27T18:02:52,1000,0,TELEVINTI4,0009931701,,1000
010949174,2024-10-27T22:29:35,270,0,TELEVINTI4,0009969982,,270
010949245,2024-10-27T03:40:02,500,0,TELEVINTI4,0005826315,,500
010949367,2024-10-27T00:48:00,300,0,TELEVINTI4,0009996364,,300
010949428,2024-10-27T10:21:05,250,0,TELEVINTI4,0009969982,,250
010949429,2024-10-27T19:37:51,500,0,TELEVINTI4,0005946202,,500
010949520,2024-10-27T18:37:45,150,0,TELEVINTI4,0009993989,,150
010949522,2024-10-27T19:38:47,1000,0,TELEVINTI4,0009886737,,1000
010949524,2024-10-27T11:16:30,1000,20,ATM,0000003002,Ribeira Brava,980
010949594,2024-10-27T15:03:28,500,0,TELEVINTI4,0009881323,,500
010949629,2024-10-27T06:36:51,200,4,ATM,0000003206,Sao Miguel,196
010949728,2024-10-27T12:20:35,100,0,TELEVINTI4,0009926968,,100
010949784,2024-10-27T15:43:30,500,10,ATM,0000000202,Praia,490
010949803,2024-10-27T13:57:19,1000,0,TELEVINTI4,0005950812,,1000
010949812,2024-10-27T12:39:19,500,0,TELEVINTI4,0009552275,,500
010949815,2024-10-27T20:23:23,260,0,TELEVINTI4,0009834903,,260
010949848,2024-10-27T07:55:33,300,6,ATM,0000000604,Sal,294
010949882,2024-10-27T14:55:44,150,3,ATM,0000002701,Sao Filipe,147
010949902,2024-10-27T18:10:09,150,0,TELEVINTI4,0009787346,,150
010949907,2024-10-27T20:23:21,500,10,ATM,0000120003,Sal,490
010949919,2024-10-27T12:26:41,500,0,TELEVINTI4,0009764431,,500
010949922,2024-10-27T16:05:55,250,0,TELEVINTI4,0009578792,,250
010949944,2024-10-27T11:29:33,250,0,TELEVINTI4,0009531046,,250
010949990,2024-10-27T18:25:02,610,12,ATM,0000000901,Sao Vicente,598
010950032,2024-10-27T14:17:24,250,0,TELEVINTI4,0009969163,,250
010950061,2024-10-27T15:13:11,500,0,TELEVINTI4,0005846162,,500
010950064,2024-10-27T03:40:16,500,10,ATM,0000000701,Sal,490
010950103,2024-10-27T16:45:05,200,0,TELEVINTI4,0009130830,,200
010950163,2024-10-27T19:15:37,500,0,TELEVINTI4,0005918084,,500
010950167,2024-10-27T17:58:01,1000,20,ATM,0000000904,Sao Vicente,980
010950183,2024-10-27T19:38:46,250,5,ATM,0000000904,Sao Vicente,245
010950196,2024-10-27T15:58:52,350,0,TELEVINTI4,0009571966,,350
010950211,2024-10-27T01:45:12,200,4,ATM,0000100105,Praia,196
010950231,2024-10-27T19:00:42,250,0,TELEVINTI4,0009565864,,250
010950260,2024-10-27T14:40:18,300,0,TELEVINTI4,0009924862,,300
010950300,2024-10-27T18:03:54,700,14,ATM,0000000115,Praia,686
010950359,2024-10-27T17:58:08,1000,20,ATM,0000000802,Ribeira Grande,980
010950430,2024-10-27T11:29:45,500,0,TELEVINTI4,0009948554,,500
010950438,2024-10-27T00:50:08,500,0,TELEVINTI4,0009855901,,500
010950441,2024-10-27T20:58:45,200,4,ATM,0000003801,Praia,196
010950489,2024-10-27T11:33:31,200,4,ATM,0000001405,Praia,196
010950497,2024-10-27T13:49:53,500,0,TELEVINTI4,0009887978,,500
010950506,2024-10-27T11:03:14,190,0,TELEVINTI4,0009973240,,190
010950585,2024-10-27T11:02:25,500,10,ATM,0000000902,Brava,490
010950598,2024-10-27T20:25:54,250,0,TELEVINTI4,0009750979,,250
010950613,2024-10-27T15:30:33,350,7,ATM,0000000306,Sao Vicente,343
010950635,2024-10-27T18:54:56,250,0,TELEVINTI4,0009966820,,250
010950655,2024-10-27T20:58:48,500,0,TELEVINTI4,0005924833,,500
010950697,2024-10-27T18:29:49,50,0,TELEVINTI4,0009922725,,50
010950747,2024-10-27T20:23:49,250,0,TELEVINTI4,0009834903,,250
010950756,2024-10-27T15:58:58,500,0,TELEVINTI4,0009561208,,500
010950800,2024-10-27T11:03:41,1000,20,ATM,0000120003,Sal,980
010950805,2024-10-27T11:02:27,110,0,TELEVINTI4,0009827939,,110
010950835,2024-10-27T15:31:41,500,10,ATM,0000000108,Praia,490
010950837,2024-10-27T16:18:52,500,0,TELEVINTI4,0009724868,,500
010950849,2024-10-27T12:49:27,500,10,ATM,0000000803,Praia,490
010950908,2024-10-27T16:28:30,1000,20,ATM,0000000901,Sao Vicente,980
010950959,2024-10-27T12:06:24,50,0,TELEVINTI4,0009127989,,50
010950974,2024-10-27T11:08:24,500,0,TELEVINTI4,0009912466,,500
010950975,2024-10-27T12:21:00,200,0,TELEVINTI4,0009846524,,200
010951140,2024-10-27T13:13:51,150,0,TELEVINTI4,0009161260,,150
010951165,2024-10-27T13:48:57,100,0,TELEVINTI4,0009737992,,100
010951237,2024-10-27T14:06:52,500,0,TELEVINTI4,0009235730,,500
010951352,2024-10-27T12:27:25,1110,0,TELEVINTI4,0009938473,,1110
010951356,2024-10-27T13:49:29,1000,0,TELEVINTI4,0005932211,,1000
010951358,2024-10-27T19:29:06,500,0,TELEVINTI4,0005986221,,500
010951398,2024-10-27T15:30:59,500,0,TELEVINTI4,0005967370,,500
010951409,2024-10-27T16:58:15,50,0,TELEVINTI4,0005816758,,50
010951431,2024-10-27T17:26:59,150,0,TELEVINTI4,0005932962,,150
010951432,2024-10-27T15:03:31,250,5,ATM,0000120004,Sal,245
010951460,2024-10-27T15:31:35,250,0,TELEVINTI4,0009763403,,250
010951468,2024-10-27T21:35:46,300,6,ATM,0000007203,Praia,294
010951473,2024-10-27T17:03:21,150,3,ATM,0000000115,Praia,147
010951544,2024-10-27T11:33:27,250,5,ATM,0000003201,Tarrafal de Sao,245
010951567,2024-10-27T16:50:05,1000,0,TELEVINTI4,0009959430,,1000
010951603,2024-10-27T15:03:53,200,0,TELEVINTI4,0009789401,,200
010951680,2024-10-27T10:25:42,90,0,TELEVINTI4,0009768794,,90
010951705,2024-10-27T16:14:32,150,0,TELEVINTI4,0009919261,,150
010951724,2024-10-27T14:40:36,1000,0,TELEVINTI4,0009813901,,1000
010951745,2024-10-27T12:49:48,500,10,ATM,0000001804,Tarrafal,490
010951858,2024-10-27T04:42:12,250,0,TELEVINTI4,0009535308,,250
010951965,2024-10-27T20:27:18,250,5,ATM,0000000306,Sal,245
010952035,2024-10-27T10:47:40,1000,0,TELEVINTI4,0009569684,,1000
010952118,2024-10-27T19:52:40,50,0,TELEVINTI4,0005822010,,50
010952135,2024-10-27T13:50:28,1000,0,TELEVINTI4,0009999098,,1000
010952137,2024-10-27T09:54:50,150,3,ATM,0000000803,Praia,147
010952139,2024-10-27T13:25:20,150,0,TELEVINTI4,0009533509,,150
010952187,2024-10-27T16:39:19,500,0,TELEVINTI4,0009317511,,500
010952190,2024-10-27T15:43:33,500,0,TELEVINTI4,0009702447,,500
010952194,2024-10-27T19:29:47,250,0,TELEVINTI4,0005843206,,250
010952215,2024-10-27T14:23:03,488,0,TELEVINTI4,0009589424,,488
010952271,2024-10-27T23:27:33,350,0,TELEVINTI4,0009733310,,350
010952306,2024-10-27T09:30:15,300,6,ATM,0000003001,Porto Novo,294
010952338,2024-10-27T14:30:50,300,6,ATM,0000003801,Praia,294
010952365,2024-10-27T18:55:19,500,10,ATM,0000003504,Praia,490
010952367,2024-10-27T11:23:26,250,0,TELEVINTI4,0005866210,,250
010952407,2024-10-27T11:09:00,1000,0,TELEVINTI4,0009785691,,1000
010952417,2024-10-27T21:48:10,500,0,TELEVINTI4,0005872054,,500
010952478,2024-10-27T12:27:37,300,6,ATM,0000001401,Boa Vista,294
010952529,2024-10-27T11:41:06,200,0,TELEVINTI4,0009894176,,200
010952542,2024-10-27T06:38:34,500,10,ATM,0000000305,Sal,490
010952552,2024-10-27T11:41:14,1000,0,TELEVINTI4,0009923643,,1000
010952568,2024-10-27T15:39:22,300,6,ATM,0000000803,Praia,294
010952579,2024-10-27T21:16:20,1000,20,ATM,0000004706,Praia,980
010952583,2024-10-27T19:01:49,160,0,TELEVINTI4,0005876119,,160
010952636,2024-10-27T11:41:08,500,10,ATM,0000120002,Sal,490
010952670,2024-10-27T11:22:40,300,6,ATM,0000001401,Boa Vista,294
010952689,2024-10-27T19:29:29,235,0,TELEVINTI4,0005885786,,235
010952695,2024-10-27T23:27:31,150,0,TELEVINTI4,0005973309,,150
010952708,2024-10-27T11:22:17,200,4,ATM,0000005303,Santa Catarina,196
010952756,2024-10-27T13:46:44,50,0,TELEVINTI4,0009882834,,50
010952839,2024-10-27T15:38:25,1000,20,ATM,0000000801,Santa Catarina,980
010952860,2024-10-27T15:38:08,100,0,TELEVINTI4,0009531629,,100
010952882,2024-10-27T17:54:28,100,0,TELEVINTI4,0009801255,,100
010952904,2024-10-27T13:25:40,200,4,ATM,0000120004,Sal,196
010952921,2024-10-27T16:40:47,490,10,ATM,0000120004,Sal,480
010952934,2024-10-27T14:12:49,300,0,TELEVINTI4,0009977792,,300
010952950,2024-10-27T20:28:16,200,0,TELEVINTI4,0009881859,,200
010952959,2024-10-27T18:55:16,50,1,ATM,0000000306,Sao Vicente,49
010952987,2024-10-27T13:25:43,60,0,TELEVINTI4,0009548020,,60
010953063,2024-10-27T19:29:16,250,0,TELEVINTI4,0009501607,,250
010953092,2024-10-27T19:39:56,200,4,ATM,0000000213,Sao Vicente,196
010953106,2024-10-27T10:48:12,70,0,TELEVINTI4,0005961490,,70
010953190,2024-10-27T10:11:03,100,0,TELEVINTI4,0009561283,,100
010953297,2024-10-27T16:37:35,150,0,TELEVINTI4,0005912132,,150
010953391,2024-10-27T05:05:56,50,1,ATM,0000001006,Praia,49
010953416,2024-10-27T18:16:50,500,0,TELEVINTI4,0005948550,,500
010953453,2024-10-27T09:39:36,150,0,TELEVINTI4,0009961396,,150
010953619,2024-10-27T08:30:06,500,0,TELEVINTI4,0005907876,,500
010953648,2024-10-27T16:54:14,300,0,TELEVINTI4,0009889926,,300
010953665,2024-10-27T15:32:21,250,0,TELEVINTI4,0009746356,,250
010953718,2024-10-27T10:49:32,205,0,TELEVINTI4,0009875800,,205
010953862,2024-10-27T20:59:02,50,0,TELEVINTI4,0005969983,,50
010953872,2024-10-27T08:49:42,1000,0,TELEVINTI4,0009518524,,1000
010953898,2024-10-27T20:29:55,250,0,TELEVINTI4,0009835369,,250
010953920,2024-10-27T21:00:14,500,0,TELEVINTI4,0009929985,,500
010953973,2024-10-27T17:11:57,500,10,ATM,0000000305,Sal,490
010953998,2024-10-27T11:16:54,500,10,ATM,0000000802,Praia,490
010954009,2024-10-27T18:13:42,500,0,TELEVINTI4,0009337800,,500
010954024,2024-10-27T12:27:50,1000,20,ATM,0000000115,Praia,980
010954025,2024-10-27T18:18:12,100,0,TELEVINTI4,0009764266,,100
010954078,2024-10-27T17:45:04,110,0,TELEVINTI4,0009786342,,110
010954099,2024-10-27T19:16:05,200,0,TELEVINTI4,0009774812,,200
010954179,2024-10-27T07:58:05,1000,0,TELEVINTI4,0009999911,,1000
010954189,2024-10-27T17:44:44,150,3,ATM,0000000107,Praia,147
010954202,2024-10-27T14:23:53,300,6,ATM,0000120002,Sal,294
010954239,2024-10-27T18:38:03,500,0,TELEVINTI4,0009785912,,500
010954273,2024-10-27T10:48:53,1000,0,TELEVINTI4,0009872028,,1000
010954358,2024-10-27T09:13:36,500,0,TELEVINTI4,0009990380,,500
010954604,2024-10-27T18:11:15,250,0,TELEVINTI4,0005945451,,250
010954605,2024-10-27T04:55:55,1000,20,ATM,0000003201,Tarrafal de Sao,980
010954652,2024-10-27T20:11:17,100,0,TELEVINTI4,0005974634,,100
010954681,2024-10-27T13:14:04,500,10,ATM,0000001809,Ribeira Grande,490
010954692,2024-10-27T23:28:32,50,0,TELEVINTI4,0009962649,,50
010954712,2024-10-27T19:58:05,700,0,TELEVINTI4,0009976116,,700
010954731,2024-10-27T15:40:40,1000,20,ATM,0000100402,Praia,980
010954737,2024-10-27T14:13:18,250,0,TELEVINTI4,0009779277,,250
010954777,2024-10-27T11:04:04,150,0,TELEVINTI4,0009940395,,150
010954815,2024-10-27T14:30:51,700,14,ATM,0000000301,Praia,686
010954846,2024-10-27T09:13:29,1000,0,TELEVINTI4,0005805051,,1000
010954860,2024-10-27T19:29:52,1000,20,ATM,0000150101,Sao Filipe,980
010954862,2024-10-27T10:17:23,1000,20,ATM,0000003106,Maio,980
010954863,2024-10-27T12:28:03,250,0,TELEVINTI4,0009778772,,250
010954864,2024-10-27T15:51:09,150,0,TELEVINTI4,0009806513,,150
010954889,2024-10-27T14:34:37,500,0,TELEVINTI4,0009739689,,500
010954890,2024-10-27T08:31:10,150,0,TELEVINTI4,0009984794,,150
010954903,2024-10-27T14:33:23,250,0,TELEVINTI4,0009809526,,250
010954912,2024-10-27T18:30:46,70,0,TELEVINTI4,0009922725,,70
010954919,2024-10-27T08:42:19,200,4,ATM,0000004706,Praia,196
010954985,2024-10-27T16:29:07,1000,20,ATM,0000000901,Sao Vicente,980
010954989,2024-10-27T16:41:19,1000,20,ATM,0000003001,Porto Novo,980
010955014,2024-10-27T12:29:01,250,0,TELEVINTI4,0009886664,,250
010955034,2024-10-27T19:40:01,200,4,ATM,0000559420,Praia,196
010955076,2024-10-27T18:30:48,500,0,TELEVINTI4,0009599197,,500
010955120,2024-10-27T18:38:08,1000,0,TELEVINTI4,0009922731,,1000
010955136,2024-10-27T16:21:44,700,14,ATM,0000000305,Sal,686
010955141,2024-10-27T12:28:01,300,6,ATM,0000003201,Tarrafal de Sao,294
010955164,2024-10-27T14:57:04,500,10,ATM,0000000202,Praia,490
010955251,2024-10-27T14:33:08,350,7,ATM,0000003303,Sao Vicente,343
010955288,2024-10-27T14:02:41,1000,0,TELEVINTI4,0009738877,,1000
010955317,2024-10-27T16:41:27,200,0,TELEVINTI4,0009821847,,200
010955351,2024-10-27T17:27:21,300,6,ATM,0000559409,Praia,294
010955364,2024-10-27T16:51:23,150,3,ATM,0000002701,Sao Filipe,147
010955365,2024-10-27T10:35:48,1000,0,TELEVINTI4,0009873122,,1000
010955388,2024-10-27T12:45:34,150,0,TELEVINTI4,0009792425,,150
010955397,2024-10-27T18:30:10,250,0,TELEVINTI4,0005948550,,250
010955402,2024-10-27T17:11:58,200,4,ATM,0000002905,Boa Vista,196
010955466,2024-10-27T19:40:24,200,0,TELEVINTI4,0009889743,,200
010955490,2024-10-27T18:38:12,1000,0,TELEVINTI4,0009997536,,1000
010955515,2024-10-27T19:02:28,500,0,TELEVINTI4,0009995335,,500
010955530,2024-10-27T20:11:59,250,5,ATM,0000000904,Sao Vicente,245
010955561,2024-10-27T18:13:46,500,10,ATM,0000000305,Sal,490
010955571,2024-10-27T17:05:08,500,0,TELEVINTI4,0005830075,,500
010955597,2024-10-27T16:59:15,150,0,TELEVINTI4,0009715866,,150
010955618,2024-10-27T19:03:47,150,0,TELEVINTI4,0009594879,,150
010955623,2024-10-27T11:09:08,250,0,TELEVINTI4,0009591475,,250
010955647,2024-10-27T17:39:39,1000,0,TELEVINTI4,0009976552,,1000
010955662,2024-10-27T13:35:12,200,0,TELEVINTI4,0009924812,,200
010955669,2024-10-27T13:17:56,500,10,ATM,0000001006,Praia,490
010955675,2024-10-27T18:30:25,1000,0,TELEVINTI4,0009779009,,1000
010955686,2024-10-27T16:19:29,250,0,TELEVINTI4,0009987589,,250
010955700,2024-10-27T13:07:53,1000,20,ATM,0000004003,Tarrafal de Sao,980
010955773,2024-10-27T21:36:57,200,0,TELEVINTI4,0005815193,,200
010955785,2024-10-27T19:03:11,150,0,TELEVINTI4,0009566277,,150
010955803,2024-10-27T20:31:08,100,0,TELEVINTI4,0009931852,,100
010955862,2024-10-27T19:53:15,250,0,TELEVINTI4,0009918604,,250
010955888,2024-10-27T09:02:11,1000,0,TELEVINTI4,0009872931,,1000
010955905,2024-10-27T21:17:13,100,0,TELEVINTI4,0005860082,,100
010955931,2024-10-27T12:29:39,300,6,ATM,0000003201,Tarrafal de Sao,294
010955949,2024-10-27T15:23:57,1000,20,ATM,0000002701,Sao Filipe,980
010955959,2024-10-27T14:17:43,1000,20,ATM,0000000210,Sao Vicente,980
010955960,2024-10-27T08:11:04,150,0,TELEVINTI4,0009773828,,150
010955991,2024-10-27T01:52:29,260,0,TELEVINTI4,0009511669,,260
010956000,2024-10-27T23:36:01,500,10,ATM,0000002101,Sal,490
010956004,2024-10-27T13:18:59,250,0,TELEVINTI4,0005985787,,250
010956022,2024-10-27T13:26:42,1000,20,ATM,0000002602,Paul,980
010956048,2024-10-27T13:18:57,150,0,TELEVINTI4,0009712407,,150
010956056,2024-10-27T10:04:55,500,0,TELEVINTI4,0009514489,,500
010956057,2024-10-27T18:14:16,150,3,ATM,0000000108,Praia,147
010956093,2024-10-27T14:13:45,600,0,TELEVINTI4,0009275330,,600
010956095,2024-10-27T21:17:40,500,0,TELEVINTI4,0009973240,,500
010956098,2024-10-27T08:34:50,50,0,TELEVINTI4,0009503315,,50
010956109,2024-10-27T18:44:46,500,0,TELEVINTI4,0009712549,,500
010956134,2024-10-27T18:04:13,250,0,TELEVINTI4,0009946463,,250
010956136,2024-10-27T21:37:21,500,0,TELEVINTI4,0009576043,,500
010956170,2024-10-27T18:31:11,500,0,TELEVINTI4,0009521456,,500
010956197,2024-10-27T14:53:25,110,0,TELEVINTI4,0009944210,,110
010956207,2024-10-27T17:40:20,500,0,TELEVINTI4,0009773828,,500
010956266,2024-10-27T14:52:42,150,0,TELEVINTI4,0005998454,,150
010956281,2024-10-27T13:01:33,50,0,TELEVINTI4,0009889875,,50
010956317,2024-10-27T13:47:49,250,0,TELEVINTI4,0005951528,,250
010956322,2024-10-27T09:02:07,500,10,ATM,0000011301,Sal,490
010956338,2024-10-27T15:32:48,200,0,TELEVINTI4,0009560295,,200
010956383,2024-10-27T18:43:58,1000,20,ATM,0000001401,Boa Vista,980
010956402,2024-10-27T11:52:28,250,5,ATM,0000001406,Praia,245
010956411,2024-10-27T18:44:11,300,0,TELEVINTI4,0009948090,,300
010956450,2024-10-27T14:52:16,250,0,TELEVINTI4,0005985787,,250
010956470,2024-10-27T15:33:49,500,0,TELEVINTI4,0009970492,,500
010956525,2024-10-27T15:44:09,150,0,TELEVINTI4,0009986449,,150
010956552,2024-10-27T10:04:51,150,0,TELEVINTI4,0009930361,,150
010956569,2024-10-27T10:22:32,1000,20,ATM,0000002301,Praia,980
010956572,2024-10-27T00:27:19,250,0,TELEVINTI4,0005858176,,250
010956574,2024-10-27T01:47:49,250,0,TELEVINTI4,0009804275,,250
010956583,2024-10-27T15:33:09,500,0,TELEVINTI4,0009970492,,500
010956646,2024-10-27T17:06:08,250,0,TELEVINTI4,0005918084,,250
010956654,2024-10-27T10:04:58,1000,0,TELEVINTI4,0009520647,,1000
010956675,2024-10-27T15:13:50,50,0,TELEVINTI4,0009799178,,50
010956708,2024-10-27T15:14:49,500,0,TELEVINTI4,0009279722,,500
010956754,2024-10-27T13:01:37,300,0,TELEVINTI4,0009987365,,300
010956756,2024-10-27T19:58:18,200,4,ATM,0000000307,Sal,196
010956790,2024-10-27T22:14:55,500,10,ATM,0000001006,Praia,490
010956810,2024-10-27T09:55:36,110,2,ATM,0000100106,Praia,108
010956834,2024-10-27T14:52:12,250,0,TELEVINTI4,0005945635,,250
010956836,2024-10-27T08:32:55,110,0,TELEVINTI4,0009503315,,110
010956854,2024-10-27T15:33:04,500,0,TELEVINTI4,0009536798,,500
010956880,2024-10-27T15:14:33,230,0,TELEVINTI4,0009859245,,230
010956888,2024-10-27T22:30:31,150,3,ATM,0000120002,Sal,147
010956890,2024-10-27T18:43:20,250,0,TELEVINTI4,0005841026,,250
010956904,2024-10-27T17:12:06,500,10,ATM,0000000301,Praia,490
010956922,2024-10-27T12:45:43,1000,0,TELEVINTI4,0009880590,,1000
010956967,2024-10-27T09:24:06,500,0,TELEVINTI4,0009572232,,500
010957025,2024-10-27T10:50:36,1000,0,TELEVINTI4,0009525559,,1000
010957035,2024-10-27T17:39:51,250,0,TELEVINTI4,0005814416,,250
010957039,2024-10-27T15:14:38,500,10,ATM,0000001303,Praia,490
010957070,2024-10-27T16:01:04,200,0,TELEVINTI4,0005950495,,200
010957076,2024-10-27T12:21:33,500,0,TELEVINTI4,0009520891,,500
010957078,2024-10-27T11:41:34,300,6,ATM,0000001807,Praia,294
010957106,2024-10-27T19:42:17,500,10,ATM,0000100402,Praia,490
010957146,2024-10-27T14:53:08,350,0,TELEVINTI4,0009919583,,350
010957147,2024-10-27T20:45:03,1000,20,ATM,0000000501,Sal,980
010957174,2024-10-27T19:41:24,300,6,ATM,0000000306,Sal,294
010957180,2024-10-27T10:05:54,1000,0,TELEVINTI4,0009520647,,1000
010957185,2024-10-27T16:06:34,100,0,TELEVINTI4,0009587352,,100
010957189,2024-10-27T11:24:10,500,10,ATM,0000000101,Praia,490
010957261,2024-10-27T16:01:21,500,10,ATM,0000100401,Praia,490
010957281,2024-10-27T18:44:33,250,0,TELEVINTI4,0009885090,,250
010957296,2024-10-27T18:49:41,1000,0,TELEVINTI4,0009771134,,1000
010957300,2024-10-27T13:26:51,150,0,TELEVINTI4,0005827900,,150
010957316,2024-10-27T12:22:57,1000,0,TELEVINTI4,0005938517,,1000
010957363,2024-10-27T21:18:24,1000,0,TELEVINTI4,0009858847,,1000
010957382,2024-10-27T08:53:01,50,0,TELEVINTI4,0009944658,,50
010957392,2024-10-27T18:38:17,250,0,TELEVINTI4,0009971695,,250
010957395,2024-10-27T15:17:07,300,6,ATM,0000000501,Sal,294
010957399,2024-10-27T12:06:42,500,0,TELEVINTI4,0009916556,,500
010957401,2024-10-27T12:31:18,250,5,ATM,0000001902,Ribeira Brava,245
010957412,2024-10-27T07:37:00,550,11,ATM,0000000104,Praia,539
010957432,2024-10-27T12:55:13,50,0,TELEVINTI4,0009532199,,50
010957452,2024-10-27T09:14:21,600,0,TELEVINTI4,0009858687,,600
010957518,2024-10-27T15:18:49,200,0,TELEVINTI4,0009899508,,200
010957531,2024-10-27T01:53:27,150,0,TELEVINTI4,0009593454,,150
010957583,2024-10-27T00:28:44,250,0,TELEVINTI4,0009597767,,250
010957592,2024-10-27T11:30:30,300,6,ATM,0000000902,Brava,294
010957593,2024-10-27T17:00:51,1000,0,TELEVINTI4,0009598576,,1000
010957596,2024-10-27T15:19:07,1000,0,TELEVINTI4,0009967589,,1000
010957603,2024-10-27T13:35:36,500,0,TELEVINTI4,0009934846,,500
010957615,2024-10-27T21:01:48,1000,0,TELEVINTI4,0009582789,,1000
010957635,2024-10-27T16:06:59,200,4,ATM,0000120002,Sal,196
010957648,2024-10-27T07:38:26,100,0,TELEVINTI4,0009253072,,100
010957649,2024-10-27T07:37:43,500,0,TELEVINTI4,0009915057,,500
010957661,2024-10-27T13:50:44,100,0,TELEVINTI4,0009154581,,100
010957670,2024-10-27T16:07:24,250,0,TELEVINTI4,0009925755,,250
010957700,2024-10-27T07:38:39,250,0,TELEVINTI4,0009874106,,250
010957746,2024-10-27T18:06:50,250,0,TELEVINTI4,0005984157,,250
010957750,2024-10-27T07:38:21,500,0,TELEVINTI4,0009985476,,500
010957757,2024-10-27T16:33:01,120,0,TELEVINTI4,0009893012,,120
010957771,2024-10-27T10:22:42,500,10,ATM,0000000401,Praia,490
010957780,2024-10-27T18:31:35,250,0,TELEVINTI4,0009516951,,250
010957787,2024-10-27T12:29:59,500,10,ATM,0000003704,Sao Vicente,490
010957799,2024-10-27T15:16:10,50,0,TELEVINTI4,0009589058,,50
010957800,2024-10-27T21:37:36,50,0,TELEVINTI4,0009324524,,50
010957816,2024-10-27T18:04:24,300,6,ATM,0000000906,Sao Vicente,294
010957822,2024-10-27T13:14:06,150,0,TELEVINTI4,0009174887,,150
010957854,2024-10-27T11:24:44,1000,20,ATM,0000000904,Sao Vicente,980
010957861,2024-10-27T16:19:30,500,0,TELEVINTI4,0009862794,,500
010957903,2024-10-27T18:07:12,200,4,ATM,0000001305,Praia,196
010957926,2024-10-27T16:33:22,100,0,TELEVINTI4,0009944596,,100
010957938,2024-10-27T16:22:19,500,0,TELEVINTI4,0005900281,,500
010957955,2024-10-27T14:13:49,500,0,TELEVINTI4,0005250083,,500
010957971,2024-10-27T17:59:36,1000,0,TELEVINTI4,0009832389,,1000
010957977,2024-10-27T15:16:29,500,0,TELEVINTI4,0005866418,,500
010957982,2024-10-27T19:30:42,200,4,ATM,0000001003,Praia,196
010958012,2024-10-27T22:31:26,150,0,TELEVINTI4,0009599857,,150
010958021,2024-10-27T12:16:09,250,0,TELEVINTI4,0009988672,,250
010958063,2024-10-27T09:56:36,250,5,ATM,0000100106,Praia,245
010958093,2024-10-27T14:44:56,1000,0,TELEVINTI4,0009915758,,1000
010958096,2024-10-27T12:02:15,700,0,TELEVINTI4,0009721967,,700
010958098,2024-10-27T14:58:01,250,5,ATM,0000000307,Sao Vicente,245
010958166,2024-10-27T10:26:35,250,5,ATM,0000000501,Sal,245
010958178,2024-10-27T21:01:41,1500,30,ATM,0000000212,Sao Vicente,1470
010958209,2024-10-27T14:07:50,110,0,TELEVINTI4,0005893787,,110
010958242,2024-10-27T12:46:10,500,10,ATM,0000120002,Sal,490
010958262,2024-10-27T16:01:23,160,3,ATM,0000100107,Praia,157
010958353,2024-10-27T01:54:32,200,0,TELEVINTI4,0009965216,,200
010958357,2024-10-27T14:41:13,88,0,TELEVINTI4,0009308898,,88
010958420,2024-10-27T14:02:43,500,0,TELEVINTI4,0009833092,,500
010958472,2024-10-27T08:35:21,500,0,TELEVINTI4,0009924408,,500
010958474,2024-10-27T18:06:59,1000,20,ATM,0000007203,Praia,980
010958485,2024-10-27T14:57:25,1000,0,TELEVINTI4,0009923857,,1000
010958514,2024-10-27T12:14:53,200,0,TELEVINTI4,0009804538,,200
010958557,2024-10-27T23:36:17,250,0,TELEVINTI4,0009783876,,250
010958609,2024-10-27T15:15:27,1000,20,ATM,0000000306,Santa Catarina,980
010958633,2024-10-27T12:40:41,100,0,TELEVINTI4,0005978916,,100
010958645,2024-10-27T15:24:43,1000,20,ATM,0000002905,Boa Vista,980
010958735,2024-10-27T15:17:28,500,0,TELEVINTI4,0009575771,,500
010958784,2024-10-27T19:58:47,500,10,ATM,0000000501,Sal,490
010958798,2024-10-27T11:09:37,500,0,TELEVINTI4,0005900674,,500
010958829,2024-10-27T14:07:21,200,0,TELEVINTI4,0009721623,,200
010958863,2024-10-27T13:35:29,500,0,TELEVINTI4,0005998618,,500
010958902,2024-10-27T19:17:35,600,12,ATM,0000100402,Praia,588
010958956,2024-10-27T18:38:34,500,0,TELEVINTI4,0009993463,,500
010959027,2024-10-27T12:32:06,500,0,TELEVINTI4,0009597715,,500
010959041,2024-10-27T18:56:29,150,0,TELEVINTI4,0005939762,,150
010959055,2024-10-27T11:11:14,250,5,ATM,0000005102,Paul,245
010959077,2024-10-27T05:55:40,250,5,ATM,0000110001,Sao Vicente,245
010959129,2024-10-27T12:34:02,1000,0,TELEVINTI4,0009826665,,1000
010959148,2024-10-27T15:41:57,250,0,TELEVINTI4,0009590755,,250
010959163,2024-10-27T14:41:18,700,0,TELEVINTI4,0009764169,,700
010959176,2024-10-27T18:56:29,110,2,ATM,0000003704,Sao Vicente,108
010959206,2024-10-27T17:55:01,1000,0,TELEVINTI4,0009795348,,1000
010959216,2024-10-27T17:31:27,250,0,TELEVINTI4,0009991055,,250
010959253,2024-10-27T05:39:50,1000,0,TELEVINTI4,0005923358,,1000
010959267,2024-10-27T13:43:29,250,0,TELEVINTI4,0009737382,,250
010959312,2024-10-27T08:44:11,500,10,ATM,0000003506,Praia,490
010959360,2024-10-27T12:02:26,300,6,ATM,0000003902,Mosteiros,294
010959393,2024-10-27T09:43:04,300,0,TELEVINTI4,0009547911,,300
010959423,2024-10-27T18:19:49,250,5,ATM,0000000704,Porto Novo,245
010959467,2024-10-27T13:08:36,200,0,TELEVINTI4,0009965692,,200
010959476,2024-10-27T21:40:56,250,0,TELEVINTI4,0005929693,,250
010959484,2024-10-27T14:08:48,1000,20,ATM,0000000901,Sao Vicente,980
010959486,2024-10-27T14:41:23,1000,0,TELEVINTI4,0009506761,,1000
010959532,2024-10-27T12:55:15,50,1,ATM,0000001814,Praia,49
010959541,2024-10-27T09:15:37,1000,0,TELEVINTI4,0009525653,,1000
010959562,2024-10-27T11:31:37,150,0,TELEVINTI4,0009948554,,150
010959614,2024-10-27T09:58:48,250,0,TELEVINTI4,0009526264,,250
010959646,2024-10-27T10:57:13,300,6,ATM,0000000107,Sao Vicente,294
010959666,2024-10-27T10:07:09,500,0,TELEVINTI4,0009754334,,500
010959674,2024-10-27T13:14:25,500,0,TELEVINTI4,0009834775,,500
010959680,2024-10-27T21:03:57,250,0,TELEVINTI4,0005965361,,250
010959688,2024-10-27T08:43:35,200,4,ATM,0000000503,Boa Vista,196
010959708,2024-10-27T13:27:00,100,2,ATM,0000003504,Praia,98
010959709,2024-10-27T15:45:09,50,1,ATM,0000120002,Sal,49
010959715,2024-10-27T08:53:40,200,4,ATM,0000120004,Sal,196
010959734,2024-10-27T21:04:12,500,10,ATM,0000001006,Praia,490
010959790,2024-10-27T10:23:04,250,0,TELEVINTI4,0005876990,,250
010959794,2024-10-27T09:14:52,1000,20,ATM,0000001202,Ribeira Grande,980
010959846,2024-10-27T12:46:27,250,5,ATM,0000000701,Boa Vista,245
010959850,2024-10-27T14:08:31,250,0,TELEVINTI4,0005893787,,250
010959851,2024-10-27T12:03:08,500,0,TELEVINTI4,0005888428,,500
010959858,2024-10-27T22:15:09,150,0,TELEVINTI4,0009704540,,150
010959888,2024-10-27T12:23:38,150,0,TELEVINTI4,0005979641,,150
010959942,2024-10-27T11:10:46,1000,0,TELEVINTI4,0009399645,,1000
010959955,2024-10-27T11:41:46,500,10,ATM,0000002602,Sao Vicente,490
010959978,2024-10-27T18:56:10,150,0,TELEVINTI4,0009150170,,150
010960075,2024-10-27T05:45:05,360,7,ATM,0000000609,Sal,353
010960076,2024-10-27T12:34:11,200,4,ATM,0000000307,Sal,196
010960083,2024-10-27T13:08:14,100,0,TELEVINTI4,0009816164,,100
010960162,2024-10-27T19:05:17,500,10,ATM,0000000705,Porto Novo,490
010960166,2024-10-27T07:42:09,250,0,TELEVINTI4,0005944344,,250
010960200,2024-10-27T10:41:17,100,2,ATM,0000000901,Sao Vicente,98
010960207,2024-10-27T21:04:01,1000,0,TELEVINTI4,0009820028,,1000
010960258,2024-10-27T11:57:42,700,0,TELEVINTI4,0005872563,,700
010960269,2024-10-27T13:32:28,500,0,TELEVINTI4,0005950990,,500
010960286,2024-10-27T17:59:42,500,10,ATM,0000000802,Ribeira Grande,490
010960295,2024-10-27T12:33:54,700,14,ATM,0000100106,Praia,686
010960298,2024-10-27T23:37:53,500,0,TELEVINTI4,0009522218,,500
010960337,2024-10-27T20:14:07,1000,20,ATM,0000000902,Brava,980
010960338,2024-10-27T17:59:42,1000,0,TELEVINTI4,0009999000,,1000
010960413,2024-10-27T08:43:33,250,0,TELEVINTI4,0009738621,,250
010960489,2024-10-27T11:43:20,200,4,ATM,0000000307,Sao Vicente,196
010960510,2024-10-27T19:31:37,250,0,TELEVINTI4,0005956327,,250
010960537,2024-10-27T14:03:59,1000,20,ATM,0000001501,Sal,980
010960538,2024-10-27T10:30:57,250,0,TELEVINTI4,0009832320,,250
010960555,2024-10-27T12:56:25,100,2,ATM,0000001103,Sao Filipe,98
010960561,2024-10-27T22:16:54,500,0,TELEVINTI4,0009764585,,500
010960572,2024-10-27T12:07:31,500,0,TELEVINTI4,0009835646,,500
010960582,2024-10-27T16:22:30,150,0,TELEVINTI4,0009945466,,150
010960585,2024-10-27T17:07:03,150,0,TELEVINTI4,0009267922,,150
010960592,2024-10-27T11:43:36,500,10,ATM,0000000305,Sal,490
010960608,2024-10-27T18:00:35,300,0,TELEVINTI4,0009866766,,300
010960623,2024-10-27T14:20:46,150,3,ATM,0000000101,Praia,147
010960644,2024-10-27T13:35:52,100,0,TELEVINTI4,0009761093,,100
010960657,2024-10-27T12:07:31,1000,0,TELEVINTI4,0009843028,,1000
010960688,2024-10-27T14:20:14,250,5,ATM,0000001810,Praia,245
010960696,2024-10-27T22:17:43,1000,20,ATM,0000004705,Praia,980
010960698,2024-10-27T12:17:54,150,0,TELEVINTI4,0005973309,,150
010960706,2024-10-27T16:51:26,250,0,TELEVINTI4,0009537424,,250
010960717,2024-10-27T13:03:30,250,5,ATM,0000000802,Ribeira Grande,245
010960728,2024-10-27T12:17:05,250,5,ATM,0000000305,Sal,245
010960731,2024-10-27T14:04:31,250,0,TELEVINTI4,0005809297,,250
010960756,2024-10-27T12:17:12,150,0,TELEVINTI4,0009886745,,150
010960776,2024-10-27T10:37:44,350,0,TELEVINTI4,0009861040,,350
010960802,2024-10-27T12:57:17,150,0,TELEVINTI4,0009991282,,150
010960809,2024-10-27T12:55:47,150,0,TELEVINTI4,0009855977,,150
010960841,2024-10-27T13:58:03,1000,0,TELEVINTI4,0009865050,,1000
010960845,2024-10-27T15:45:55,80,0,TELEVINTI4,0009527004,,80
010960852,2024-10-27T08:14:16,1000,0,TELEVINTI4,0005885218,,1000
010960861,2024-10-27T14:42:01,100,0,TELEVINTI4,0009308898,,100
010960872,2024-10-27T19:31:57,1000,0,TELEVINTI4,0009800470,,1000
010960880,2024-10-27T13:44:03,550,11,ATM,0000120004,Sal,539
010960885,2024-10-27T14:20:32,250,0,TELEVINTI4,0009787518,,250
010960901,2024-10-27T10:17:59,1000,0,TELEVINTI4,0009849507,,1000
010960907,2024-10-27T11:42:54,300,0,TELEVINTI4,0009918799,,300
010960912,2024-10-27T10:35:54,500,10,ATM,0000120004,Sal,490
010960922,2024-10-27T13:20:10,150,3,ATM,0000002901,Maio,147
010960930,2024-10-27T16:30:36,150,0,TELEVINTI4,0009875836,,150
010960939,2024-10-27T12:16:25,1000,20,ATM,0000000107,Sao Vicente,980
010960958,2024-10-27T15:06:05,250,0,TELEVINTI4,0005946139,,250
010960973,2024-10-27T02:09:09,200,4,ATM,0000100106,Praia,196
010960977,2024-10-27T16:51:26,50,0,TELEVINTI4,0009725764,,50
010961043,2024-10-27T10:58:56,1000,0,TELEVINTI4,0005817063,,1000
010961058,2024-10-27T22:33:37,500,10,ATM,0000120004,Sal,490
010961076,2024-10-27T12:08:19,500,10,ATM,0000000305,Sal,490
010961134,2024-10-27T18:20:35,200,0,TELEVINTI4,0005824992,,200
010961135,2024-10-27T18:57:20,250,0,TELEVINTI4,0005974687,,250
010961146,2024-10-27T00:36:40,500,0,TELEVINTI4,0005843781,,500
010961147,2024-10-27T12:18:31,150,3,ATM,0000004003,Tarrafal de Sao,147
010961149,2024-10-27T15:25:13,500,0,TELEVINTI4,0005866418,,500
010961150,2024-10-27T10:30:19,300,6,ATM,0000000306,Sal,294
010961163,2024-10-27T14:58:59,500,10,ATM,0000002902,Boa Vista,490
010961226,2024-10-27T10:58:41,500,0,TELEVINTI4,0005980845,,500
010961227,2024-10-27T00:59:34,500,0,TELEVINTI4,0009519904,,500
010961258,2024-10-27T10:35:48,500,10,ATM,0000005303,Santa Catarina,490
010961272,2024-10-27T11:57:43,160,0,TELEVINTI4,0009926968,,160
010961305,2024-10-27T13:36:32,1000,0,TELEVINTI4,0009833676,,1000
010961308,2024-10-27T16:30:32,250,5,ATM,0000002405,Sao Vicente,245
010961316,2024-10-27T17:12:30,260,5,ATM,0000003606,Sao Vicente,255
010961329,2024-10-27T14:05:02,250,0,TELEVINTI4,0009781454,,250
010961338,2024-10-27T19:44:17,1000,0,TELEVINTI4,0005939453,,1000
010961376,2024-10-27T07:07:27,500,0,TELEVINTI4,0009985476,,500
010961408,2024-10-27T16:55:03,50,0,TELEVINTI4,0005816758,,50
010961433,2024-10-27T14:04:11,250,0,TELEVINTI4,0005809297,,250
010961472,2024-10-27T09:32:03,1000,0,TELEVINTI4,0009814550,,1000
010961483,2024-10-27T10:30:53,1000,20,ATM,0000000602,Sal,980
010961523,2024-10-27T10:58:30,100,0,TELEVINTI4,0009580168,,100
010961570,2024-10-27T11:05:55,1000,0,TELEVINTI4,0009189320,,1000
010961608,2024-10-27T18:20:12,250,0,TELEVINTI4,0005972218,,250
010961626,2024-10-27T08:54:24,700,0,TELEVINTI4,0009740830,,700
010961628,2024-10-27T10:30:19,150,0,TELEVINTI4,0009978676,,150
010961633,2024-10-27T14:25:19,500,0,TELEVINTI4,0009762966,,500
010961653,2024-10-27T07:08:42,700,14,ATM,0000000310,Sal,686
010961654,2024-10-27T09:43:14,1000,20,ATM,0000003001,Ribeira Brava,980
010961677,2024-10-27T12:17:00,1000,20,ATM,0000000803,Praia,980
010961678,2024-10-27T16:23:00,200,4,ATM,0000000506,Sal,196
010961727,2024-10-27T22:33:37,1000,0,TELEVINTI4,0009549497,,1000
010961740,2024-10-27T13:37:34,300,0,TELEVINTI4,0009959677,,300
010961817,2024-10-27T17:46:19,500,0,TELEVINTI4,0009804538,,500
010961844,2024-10-27T12:17:00,250,0,TELEVINTI4,0009855315,,250
010961846,2024-10-27T13:54:23,1000,20,ATM,0000000203,Sao Vicente,980
010961857,2024-10-27T16:15:56,500,10,ATM,0000001401,Boa Vista,490
010961888,2024-10-27T18:20:51,1000,20,ATM,0000000307,Sao Vicente,980
010961919,2024-10-27T10:57:34,200,0,TELEVINTI4,0009945996,,200
010961943,2024-10-27T23:43:43,150,3,ATM,0000001305,Praia,147
010961962,2024-10-27T21:04:50,50,0,TELEVINTI4,0009849807,,50
010961968,2024-10-27T19:31:15,250,0,TELEVINTI4,0009920568,,250
010962002,2024-10-27T14:25:21,500,10,ATM,0000000203,Sao Vicente,490
010962007,2024-10-27T16:22:30,500,0,TELEVINTI4,0009599197,,500
010962036,2024-10-27T10:38:11,250,0,TELEVINTI4,0009918604,,250
010962048,2024-10-27T19:54:11,160,0,TELEVINTI4,0009863980,,160
010962052,2024-10-27T19:19:44,500,0,TELEVINTI4,0009540205,,500
010962053,2024-10-27T10:23:23,1000,0,TELEVINTI4,0009727694,,1000
010962070,2024-10-27T18:49:59,300,6,ATM,0000004103,Praia,294
010962115,2024-10-27T16:42:11,250,5,ATM,0000000211,Sao Vicente,245
010962132,2024-10-27T21:49:20,250,0,TELEVINTI4,0009823225,,250
010962141,2024-10-27T06:03:36,500,10,ATM,0000000307,Sao Vicente,490
010962154,2024-10-27T16:02:41,500,10,ATM,0000000305,Sal,490
010962186,2024-10-27T17:34:48,260,0,TELEVINTI4,0005894681,,260
010962205,2024-10-27T08:21:18,150,0,TELEVINTI4,0009865043,,150
010962227,2024-10-27T13:32:48,1000,0,TELEVINTI4,0009810810,,1000
010962228,2024-10-27T01:02:14,110,0,TELEVINTI4,0005965456,,110
010962231,2024-10-27T14:53:51,150,3,ATM,0000000306,Sao Vicente,147
010962232,2024-10-27T08:22:57,500,10,ATM,0000000107,Sao Vicente,490
010962284,2024-10-27T02:20:43,250,5,ATM,0000000307,Sao Vicente,245
010962287,2024-10-27T08:02:28,500,10,ATM,0000000502,Sal,490
010962296,2024-10-27T21:04:53,300,0,TELEVINTI4,0009937309,,300
010962298,2024-10-27T09:05:14,100,0,TELEVINTI4,0009858562,,100
010962303,2024-10-27T08:01:46,150,0,TELEVINTI4,0009119390,,150
010962308,2024-10-27T11:19:13,100,0,TELEVINTI4,0009529237,,100
010962341,2024-10-27T14:38:41,200,0,TELEVINTI4,0009732418,,200
010962355,2024-10-27T17:19:34,200,4,ATM,0000001804,Tarrafal,196
010962402,2024-10-27T12:36:13,150,0,TELEVINTI4,0009951424,,150
010962416,2024-10-27T13:22:02,100,0,TELEVINTI4,0009524007,,100
010962418,2024-10-27T12:37:05,500,0,TELEVINTI4,0005974719,,500
010962442,2024-10-27T12:57:56,1000,0,TELEVINTI4,0009948853,,1000
010962446,2024-10-27T09:19:57,1000,0,TELEVINTI4,0009926896,,1000
010962449,2024-10-27T17:33:34,1000,20,ATM,0000002905,Boa Vista,980
010962478,2024-10-27T02:18:14,180,0,TELEVINTI4,0009247411,,180
010962483,2024-10-27T18:21:44,200,4,ATM,0000003106,Maio,196
010962493,2024-10-27T18:50:04,500,0,TELEVINTI4,0009726370,,500
010962515,2024-10-27T14:59:05,250,0,TELEVINTI4,0005986221,,250
010962560,2024-10-27T10:23:43,500,10,ATM,0000004705,Praia,490
010962599,2024-10-27T16:41:53,300,0,TELEVINTI4,0009867592,,300
010962613,2024-10-27T08:23:56,150,3,ATM,0000000107,Sao Vicente,147
010962617,2024-10-27T12:35:55,100,0,TELEVINTI4,0005804049,,100
010962622,2024-10-27T09:19:17,300,6,ATM,0000000105,Praia,294
010962662,2024-10-27T11:58:27,500,0,TELEVINTI4,0009998091,,500
010962666,2024-10-27T16:30:43,1000,0,TELEVINTI4,0005990754,,1000
010962682,2024-10-27T12:35:18,150,0,TELEVINTI4,0009519127,,150
010962696,2024-10-27T16:08:34,150,0,TELEVINTI4,0005983487,,150
010962712,2024-10-27T09:43:29,1000,0,TELEVINTI4,0009986321,,1000
010962723,2024-10-27T09:19:27,50,1,ATM,0000001405,Praia,49
010962725,2024-10-27T18:21:46,500,0,TELEVINTI4,0009152369,,500
010962727,2024-10-27T16:12:22,200,0,TELEVINTI4,0009587352,,200
010962767,2024-10-27T15:26:13,150,0,TELEVINTI4,0009964885,,150
010962786,2024-10-27T14:14:15,250,0,TELEVINTI4,0009932697,,250
010962821,2024-10-27T18:49:41,50,0,TELEVINTI4,0005873332,,50
010962827,2024-10-27T16:42:35,350,7,ATM,0000120203,Sal,343
010962846,2024-10-27T09:06:01,500,0,TELEVINTI4,0009991402,,500
010962872,2024-10-27T15:26:29,500,10,ATM,0000100106,Praia,490
010962885,2024-10-27T18:50:00,1000,20,ATM,0000004705,Praia,980
010962888,2024-10-27T14:59:16,150,0,TELEVINTI4,0009967508,,150
010962898,2024-10-27T13:55:06,350,0,TELEVINTI4,0009931727,,350
010962912,2024-10-27T13:44:47,50,0,TELEVINTI4,0009934846,,50
010962958,2024-10-27T19:18:30,150,3,ATM,0000000901,Sao Vicente,147
010962972,2024-10-27T13:55:09,1000,0,TELEVINTI4,0009912061,,1000
010962990,2024-10-27T21:05:25,250,0,TELEVINTI4,0009986615,,250
010963005,2024-10-27T22:23:23,500,10,ATM,0000100201,Praia,490
010963013,2024-10-27T20:00:16,1000,20,ATM,0000001807,Praia,980
010963028,2024-10-27T19:32:21,1000,0,TELEVINTI4,0009941510,,1000
010963225,2024-10-27T19:22:19,500,0,TELEVINTI4,0009955865,,500
010963243,2024-10-27T23:51:26,250,0,TELEVINTI4,0005841026,,250
010963329,2024-10-27T20:35:18,610,0,TELEVINTI4,0009930055,,610
010963336,2024-10-27T20:35:48,500,0,TELEVINTI4,0009721157,,500
010963348,2024-10-27T19:54:20,150,0,TELEVINTI4,0005925240,,150
010963367,2024-10-27T23:50:33,200,0,TELEVINTI4,0005949868,,200
010963376,2024-10-27T21:23:40,500,0,TELEVINTI4,0005914231,,500
010963384,2024-10-27T22:38:04,700,14,ATM,0000001405,Praia,686
010963398,2024-10-27T19:32:24,300,6,ATM,0000150101,Sao Filipe,294
010963403,2024-10-27T19:21:14,500,0,TELEVINTI4,0009884598,,500
010963568,2024-10-27T22:22:24,400,8,ATM,0000007203,Praia,392
010963621,2024-10-27T20:00:04,100,2,ATM,0000000307,Sal,98
010963633,2024-10-27T19:59:40,1000,0,TELEVINTI4,0009597163,,1000
010963781,2024-10-27T22:21:29,1100,0,TELEVINTI4,0009917893,,1100
010963782,2024-10-27T21:05:34,250,0,TELEVINTI4,0009749059,,250
010963972,2024-10-27T22:34:59,250,0,TELEVINTI4,0009777736,,250
010964101,2024-10-27T21:25:52,80,0,TELEVINTI4,0009504364,,80
010964148,2024-10-27T19:44:59,500,10,ATM,0000001305,Praia,490
010964175,2024-10-27T21:05:57,1000,20,ATM,0000003201,Tarrafal de Sao,980
010964186,2024-10-27T20:34:10,250,0,TELEVINTI4,0009873728,,250
010964482,2024-10-27T22:39:19,250,0,TELEVINTI4,0009864888,,250
010964500,2024-10-27T22:46:35,1000,20,ATM,0000004706,Praia,980
010964558,2024-10-27T22:49:07,1000,0,TELEVINTI4,0005811440,,1000
010964600,2024-10-27T20:48:12,260,0,TELEVINTI4,0005945281,,260
010964618,2024-10-27T22:49:03,500,0,TELEVINTI4,0009761795,,500
010964657,2024-10-27T22:58:04,200,4,ATM,0000001813,Praia,196
010964687,2024-10-27T21:06:57,110,0,TELEVINTI4,0005924833,,110
010964863,2024-10-27T21:42:15,200,0,TELEVINTI4,0009740533,,200
010964866,2024-10-27T21:41:37,500,0,TELEVINTI4,0009574657,,500
010964933,2024-10-27T19:22:19,150,3,ATM,0000120004,Sal,147
010964934,2024-10-27T22:46:30,250,0,TELEVINTI4,0009924648,,250
010964990,2024-10-27T22:50:41,100,0,TELEVINTI4,0009529961,,100
010965009,2024-10-27T22:51:08,500,0,TELEVINTI4,0009575676,,500
010965090,2024-10-27T22:57:27,500,0,TELEVINTI4,0009502169,,500
010965228,2024-10-27T20:37:05,1000,0,TELEVINTI4,0005847648,,1000
010965249,2024-10-27T20:37:14,500,0,TELEVINTI4,0009817077,,500
010965337,2024-10-27T22:39:48,300,0,TELEVINTI4,0009971096,,300
010965339,2024-10-27T21:07:13,1000,0,TELEVINTI4,0009582789,,1000
010965465,2024-10-27T22:48:08,250,0,TELEVINTI4,0005874499,,250
010965863,2024-10-27T20:46:30,250,0,TELEVINTI4,0009578792,,250
010965992,2024-10-27T19:45:18,220,0,TELEVINTI4,0005820250,,220
010966038,2024-10-27T19:23:37,150,0,TELEVINTI4,0005973309,,150
010966064,2024-10-28T00:00:41,350,0,TELEVINTI4,0005950462,,350
010966068,2024-10-27T19:07:47,700,14,ATM,0000003704,Sao Vicente,686
010966075,2024-10-27T19:07:34,300,0,TELEVINTI4,0009767731,,300
010966105,2024-10-27T20:05:11,120,2,ATM,0000000310,Sal,118
010966110,2024-10-27T19:25:24,150,0,TELEVINTI4,0009822438,,150
010966151,2024-10-27T19:25:37,1000,20,ATM,0000001501,Sal,980
010966157,2024-10-27T19:08:22,500,10,ATM,0000000208,Sao Vicente,490
010966248,2024-10-27T20:52:51,260,0,TELEVINTI4,0005815753,,260
010966279,2024-10-27T20:50:55,250,0,TELEVINTI4,0009594048,,250
010966281,2024-10-27T19:07:11,1000,0,TELEVINTI4,0009714498,,1000
010966306,2024-10-27T20:02:00,1000,20,ATM,0000000212,Sao Vicente,980
010966365,2024-10-27T20:50:37,1000,0,TELEVINTI4,0009576649,,1000
010966377,2024-10-27T20:51:55,500,0,TELEVINTI4,0009579201,,500
010966525,2024-10-27T19:08:28,500,10,ATM,0000000906,Sao Vicente,490
010966595,2024-10-27T20:14:46,100,0,TELEVINTI4,0009816164,,100
010966705,2024-10-27T20:02:33,1000,20,ATM,0000000305,Sao Vicente,980
010966708,2024-10-27T19:25:42,300,6,ATM,0000005403,Praia,294
010966778,2024-10-27T19:25:18,500,10,ATM,0000000701,Boa Vista,490
010966779,2024-10-27T19:24:27,200,4,ATM,0000011301,Sal,196
010966800,2024-10-27T19:07:39,200,4,ATM,0000000906,Sao Vicente,196
010966839,2024-10-27T19:06:24,1000,0,TELEVINTI4,0009946584,,1000
010966842,2024-10-27T23:05:35,500,0,TELEVINTI4,0005915034,,500
010966870,2024-10-27T21:07:37,150,0,TELEVINTI4,0009897817,,150
010966878,2024-10-27T20:48:48,200,0,TELEVINTI4,0009859313,,200
010966889,2024-10-27T21:09:50,50,0,TELEVINTI4,0009942324,,50
010966953,2024-10-27T20:02:55,250,0,TELEVINTI4,0009873728,,250
010966960,2024-10-27T19:24:28,250,5,ATM,0000005102,Paul,245
010967090,2024-10-27T19:25:36,300,0,TELEVINTI4,0009955721,,300
010967116,2024-10-27T20:16:37,500,0,TELEVINTI4,0009866887,,500
010967261,2024-10-27T20:39:26,150,0,TELEVINTI4,0009866298,,150
010967315,2024-10-27T19:23:06,500,0,TELEVINTI4,0005934360,,500
010967393,2024-10-27T19:25:10,500,0,TELEVINTI4,0005929278,,500
010967650,2024-10-27T19:46:01,500,0,TELEVINTI4,0009970886,,500
010967718,2024-10-27T19:10:19,300,6,ATM,0000120004,Sal,294
010967756,2024-10-27T20:54:38,260,0,TELEVINTI4,0009599966,,260
010967759,2024-10-27T19:11:14,300,6,ATM,0000001501,Sal,294
010967833,2024-10-27T19:45:56,200,0,TELEVINTI4,0009559064,,200
010967878,2024-10-27T22:01:13,500,0,TELEVINTI4,0009863980,,500
010967905,2024-10-27T20:55:51,100,0,TELEVINTI4,0005969983,,100
010968132,2024-10-27T23:19:06,1000,0,TELEVINTI4,0009960075,,1000
010968279,2024-10-27T23:08:18,250,0,TELEVINTI4,0009570455,,250
010968281,2024-10-27T19:10:43,250,5,ATM,0000120002,Sal,245
010968303,2024-10-27T23:13:21,500,0,TELEVINTI4,0005850872,,500
010968312,2024-10-27T23:18:24,1000,0,TELEVINTI4,0005974812,,1000
010968370,2024-10-27T23:16:19,300,6,ATM,0000000602,Sal,294
010968426,2024-10-27T19:54:40,250,0,TELEVINTI4,0009133225,,250
010968470,2024-10-27T19:11:39,500,10,ATM,0000000902,Brava,490
010968694,2024-10-27T19:32:58,500,0,TELEVINTI4,0009824701,,500
010968768,2024-10-27T22:00:08,200,4,ATM,0000003001,Porto Novo,196
010968849,2024-10-27T23:08:03,500,0,TELEVINTI4,0009738202,,500
010969145,2024-10-27T22:04:05,200,0,TELEVINTI4,0009763678,,200
010969158,2024-10-27T19:33:42,1000,20,ATM,0000000401,Sao Filipe,980
010969246,2024-10-27T22:06:34,500,10,ATM,0000000308,Sal,490
010969573,2024-10-27T19:48:48,500,10,ATM,0000003801,Praia,490
010969668,2024-10-27T19:33:56,250,0,TELEVINTI4,0005989991,,250
010969729,2024-10-27T19:49:10,150,0,TELEVINTI4,0005867148,,150
010969740,2024-10-27T22:05:32,500,0,TELEVINTI4,0009832854,,500
010969847,2024-10-27T19:26:42,110,0,TELEVINTI4,0009524465,,110
010969893,2024-10-27T20:17:49,500,0,TELEVINTI4,0009929985,,500
010970114,2024-10-27T22:27:53,1000,0,TELEVINTI4,0009946584,,1000
010970237,2024-10-27T22:02:20,200,0,TELEVINTI4,0009583028,,200
010970269,2024-10-27T19:12:14,500,0,TELEVINTI4,0009701637,,500
010970270,2024-10-27T19:33:58,1000,0,TELEVINTI4,0009560626,,1000
010970274,2024-10-27T20:40:19,500,0,TELEVINTI4,0009736063,,500
010970326,2024-10-27T22:02:27,150,0,TELEVINTI4,0005874499,,150
010970399,2024-10-27T19:49:08,1000,0,TELEVINTI4,0009975368,,1000
121324295,2024-10-27T00:26:16,1000,20,ATM,0000001406,Praia,980
121324296,2024-10-27T09:51:21,1000,20,ATM,0000559421,Praia,980
121324297,2024-10-27T11:01:43,1000,20,ATM,0000000210,Sao Vicente,980
121324298,2024-10-27T16:13:37,1000,20,ATM,0000110202,Sao Vicente,980
121324299,2024-10-27T19:14:12,1000,20,ATM,0000003506,Praia,980
121324300,2024-10-27T20:00:16,1000,20,ATM,0000120002,Sal,980
121324301,2024-10-27T20:01:31,1000,20,ATM,0000000305,Sao Vicente,980
121324302,2024-10-27T22:10:06,1000,20,ATM,0000100106,Praia,980
121324303,2024-10-27T22:22:47,1000,20,ATM,0000002201,Praia,980
243309994,2024-10-27T09:50:08,200,4,ATM,0000001804,Praia,196
243309995,2024-10-27T15:18:59,200,4,ATM,0000001303,Praia,196
351239745,2024-10-27T00:33:25,300,6,ATM,0000000107,Praia,294
351239746,2024-10-27T12:28:33,300,6,ATM,0000003201,Tarrafal de Sao,294
447621585,2024-10-27T09:57:13,350,7,ATM,0000100106,Praia,343
447621586,2024-10-27T19:55:26,350,7,ATM,0000002905,Boa Vista,343
507708950,2024-10-27T09:43:17,5000,100,ATM,0000001802,Maio,4900
507708951,2024-10-27T10:59:00,5000,100,ATM,0000003902,Mosteiros,4900
507708952,2024-10-27T14:51:48,5000,100,ATM,0000000105,Praia,4900
570814150,2024-10-27T07:58:03,500,10,ATM,0000000901,Sao Vicente,490
570814151,2024-10-27T09:24:24,500,10,ATM,0000000701,Boa Vista,490
570814152,2024-10-27T13:47:40,500,10,ATM,0000100402,Praia,490
570814153,2024-10-27T15:48:49,500,10,ATM,0000003204,Santa Cruz,490
570814154,2024-10-27T16:15:22,500,10,ATM,0000001809,Ribeira Grande,490
010926514,2024-10-27T00:07:31,110,2,POS,90000253,Praia,108
010935639,2024-10-27T00:09:12,500,10,POS,27042,Praia,490
010939828,2024-10-27T00:13:14,250,5,POS,13472,Praia,245
010962461,2024-10-27T00:40:00,200,4,POS,15976,Praia,196
010951243,2024-10-27T00:48:04,250,5,POS,25469,Praia,245
010959453,2024-10-27T00:58:28,500,10,POS,90000253,Praia,490
010915391,2024-10-27T01:03:42,1000,20,POS,10255,Praia,980
010948570,2024-10-27T01:37:12,150,3,POS,20258,Praia,147
010950922,2024-10-27T01:41:39,140,3,POS,23679,Praia,137
010958924,2024-10-27T01:55:55,250,5,POS,20967,Praia,245
010961263,2024-10-27T02:15:32,500,10,POS,23679,Praia,490
010962764,2024-10-27T02:20:56,500,10,POS,21618,Praia,490
010957645,2024-10-27T06:50:54,200,4,POS,24945,Praia,196
010954301,2024-10-27T07:29:45,500,10,POS,20719,Praia,490
010959025,2024-10-27T07:41:58,500,10,POS,26307,Praia,490
010941958,2024-10-27T07:53:38,1000,20,POS,19820,Praia,980
010918828,2024-10-27T08:05:49,300,6,POS,20130,Praia,294
010942604,2024-10-27T08:06:40,1000,20,POS,15822,Praia,980
010952746,2024-10-27T08:08:53,300,6,POS,23246,Praia,294
010961884,2024-10-27T08:15:31,500,10,POS,25775,Praia,490
010961493,2024-10-27T08:19:41,200,4,POS,90000160,Praia,196
010907287,2024-10-27T08:24:47,500,0,POS,13959,Praia,500
010950865,2024-10-27T08:29:31,1000,20,POS,8925,Sao Filipe,980
010955877,2024-10-27T08:32:03,1000,20,POS,13697,Praia,980
010960985,2024-10-27T08:36:33,1000,20,POS,17576,Praia,980
010838683,2024-10-27T08:39:19,250,5,POS,19309,Praia,245
010955084,2024-10-27T08:42:07,500,10,POS,27578,Praia,490
010959844,2024-10-27T08:45:28,490,10,POS,90000147,Praia,480
010959619,2024-10-27T08:46:53,1000,20,POS,18389,Praia,980
010877367,2024-10-27T08:46:58,500,10,POS,18087,Praia,490
010905135,2024-10-27T08:47:00,1000,20,POS,18372,Praia,980
010949847,2024-10-27T08:49:28,500,10,POS,24754,Praia,490
010925712,2024-10-27T08:55:34,50,1,POS,19866,Praia,49
010955992,2024-10-27T09:02:46,500,10,POS,24272,Praia,490
010962351,2024-10-27T09:04:14,150,3,POS,24272,Praia,147
010912754,2024-10-27T09:06:53,250,5,POS,21107,Praia,245
010962364,2024-10-27T09:19:25,150,3,POS,90000160,Praia,147
010926456,2024-10-27T09:25:50,100,2,POS,21107,Praia,98
010950122,2024-10-27T09:37:21,200,4,POS,29448,Praia,196
010950933,2024-10-27T09:38:33,250,5,POS,16171,Praia,245
010950198,2024-10-27T09:38:46,260,5,POS,17678,Praia,255
010885765,2024-10-27T09:43:35,250,5,POS,28941,Praia,245
010906759,2024-10-27T09:43:57,100,2,POS,28196,Praia,98
010907655,2024-10-27T09:44:08,250,5,POS,21901,Praia,245
010919016,2024-10-27T09:44:18,250,5,POS,26298,Praia,245
010960034,2024-10-27T09:59:29,150,3,POS,24949,Praia,147
010962522,2024-10-27T10:00:45,250,5,POS,18283,Praia,245
010951360,2024-10-27T10:02:26,100,2,POS,26335,Praia,98
010950984,2024-10-27T10:03:18,250,5,POS,22413,Praia,245
010959436,2024-10-27T10:07:53,500,10,POS,23410,Praia,490
010919593,2024-10-27T10:08:25,250,5,POS,26761,Praia,245
010952499,2024-10-27T10:11:56,150,3,POS,22351,Praia,147
010962498,2024-10-27T10:13:33,500,10,POS,23410,Praia,490
010936055,2024-10-27T10:16:20,500,10,POS,28606,Praia,490
010945638,2024-10-27T10:16:36,600,12,POS,24949,Praia,588
010959924,2024-10-27T10:17:39,300,6,POS,28685,Praia,294
010933561,2024-10-27T10:18:55,1000,20,POS,17489,Praia,980
010956437,2024-10-27T10:22:14,250,5,POS,19339,Praia,245
010937608,2024-10-27T10:25:22,250,5,POS,9102,Sal,245
010961489,2024-10-27T10:29:24,260,5,POS,26127,Praia,255
010961394,2024-10-27T10:29:40,150,3,POS,19866,Praia,147
010960548,2024-10-27T10:30:24,300,6,POS,24911,Praia,294
010910736,2024-10-27T10:31:50,200,4,POS,28200,Praia,196
010942609,2024-10-27T10:33:03,610,12,POS,27605,Praia,598
010962168,2024-10-27T10:38:15,250,5,POS,28878,Praia,245
010936406,2024-10-27T10:39:21,250,5,POS,28878,Praia,245
010951167,2024-10-27T10:40:35,100,2,POS,18603,Praia,98
010948675,2024-10-27T10:46:10,1000,20,POS,10026,Sal,980
010953807,2024-10-27T10:49:34,250,5,POS,16828,Praia,245
010958544,2024-10-27T10:51:25,200,4,POS,20719,Praia,196
010959492,2024-10-27T10:51:45,250,5,POS,27386,Praia,245
010896043,2024-10-27T10:52:53,610,12,POS,15156,Praia,598
010960659,2024-10-27T10:58:55,500,10,POS,12995,Praia,490
010931729,2024-10-27T11:00:16,1000,20,POS,14465,Praia,980
010935976,2024-10-27T11:01:07,1000,20,POS,14465,Praia,980
010955460,2024-10-27T11:05:04,500,10,POS,15316,Praia,490
010956183,2024-10-27T11:05:30,300,6,POS,25930,Praia,294
010956925,2024-10-27T11:05:30,500,10,POS,21926,Praia,490
010944021,2024-10-27T11:07:50,265,5,POS,12101,Porto Novo,260
010959301,2024-10-27T11:10:24,500,10,POS,28241,Praia,490
010940424,2024-10-27T11:12:37,500,0,POS,13959,Praia,500
010945442,2024-10-27T11:13:53,150,3,POS,29043,Praia,147
010945446,2024-10-27T11:15:45,1000,20,POS,10026,Sal,980
010895296,2024-10-27T11:19:33,500,10,POS,21799,Praia,490
010931607,2024-10-27T11:19:59,300,6,POS,20130,Praia,294
010948676,2024-10-27T11:21:10,1000,20,POS,21799,Praia,980
010962309,2024-10-27T11:26:11,700,14,POS,90000147,Praia,686
010962164,2024-10-27T11:26:10,500,10,POS,21799,Praia,490
010956580,2024-10-27T11:29:55,300,6,POS,27291,Praia,294
010890428,2024-10-27T11:32:00,500,10,POS,19866,Praia,490
010884472,2024-10-27T11:32:04,250,5,POS,19370,Praia,245
010947094,2024-10-27T11:32:16,150,3,POS,26996,Praia,147
010959762,2024-10-27T11:34:28,250,5,POS,19382,Praia,245
010925491,2024-10-27T11:35:13,500,10,POS,20500,Praia,490
010925115,2024-10-27T11:47:17,500,10,POS,17514,Praia,490
010926892,2024-10-27T11:47:21,150,3,POS,20075,Praia,147
010935703,2024-10-27T11:48:43,610,12,POS,18283,Praia,598
010942924,2024-10-27T11:49:00,200,4,POS,23395,Praia,196
010955657,2024-10-27T11:51:43,500,10,POS,16171,Praia,490
010954934,2024-10-27T11:52:09,150,3,POS,17736,Praia,147
010959587,2024-10-27T11:53:15,500,10,POS,18283,Praia,490
010896239,2024-10-27T11:54:52,150,3,POS,18491,Praia,147
010903405,2024-10-27T11:55:04,120,2,POS,90000160,Praia,118
010942156,2024-10-27T11:56:37,110,2,POS,24246,Praia,108
010952530,2024-10-27T11:57:06,500,10,POS,6585,Sao Domingos,490
010956614,2024-10-27T11:57:22,1000,20,POS,18491,Praia,980
010891794,2024-10-27T11:58:42,140,3,POS,26996,Praia,137
010934512,2024-10-27T11:59:40,1000,20,POS,16227,Praia,980
010944075,2024-10-27T12:00:42,510,10,POS,19309,Praia,500
010958522,2024-10-27T12:02:15,150,3,POS,19148,Praia,147
010946355,2024-10-27T12:05:42,250,5,POS,27571,Praia,245
010952810,2024-10-27T12:06:32,160,3,POS,18283,Praia,157
010955497,2024-10-27T12:06:34,150,3,POS,12868,Praia,147
010960535,2024-10-27T12:07:39,150,3,POS,12868,Praia,147
010942596,2024-10-27T12:12:53,500,10,POS,21682,Praia,490
010953311,2024-10-27T12:13:27,150,3,POS,29742,Praia,147
010958561,2024-10-27T12:16:01,250,5,POS,18603,Praia,245
010933061,2024-10-27T12:19:07,500,10,POS,19807,Praia,490
010946825,2024-10-27T12:20:08,150,3,POS,23395,Praia,147
010962166,2024-10-27T12:24:08,1000,20,POS,25654,Praia,980
010918770,2024-10-27T12:24:49,1000,20,POS,27963,Praia,980
010923962,2024-10-27T12:24:52,250,5,POS,27130,Praia,245
010955037,2024-10-27T12:29:33,1000,20,POS,25402,Praia,980
010881198,2024-10-27T12:37:18,1000,20,POS,24971,Praia,980
010939389,2024-10-27T12:38:35,150,3,POS,24971,Praia,147
010947120,2024-10-27T12:38:37,350,7,POS,26605,Praia,343
010949690,2024-10-27T12:38:54,160,3,POS,24971,Praia,157
010951857,2024-10-27T12:39:42,150,3,POS,26605,Praia,147
010951751,2024-10-27T12:40:30,150,3,POS,26605,Praia,147
010895644,2024-10-27T12:41:22,150,3,POS,30133,Praia,147
010941310,2024-10-27T12:44:47,250,5,POS,15567,Praia,245
010948103,2024-10-27T12:47:57,1000,20,POS,24839,Praia,980
010948893,2024-10-27T12:48:17,1000,20,POS,12995,Praia,980
010949023,2024-10-27T12:48:56,260,5,POS,28335,Praia,255
010949797,2024-10-27T12:49:22,200,4,POS,18372,Praia,196
010961293,2024-10-27T12:55:20,1000,20,POS,25303,Praia,980
010960943,2024-10-27T12:56:07,1000,20,POS,16171,Praia,980
010962832,2024-10-27T12:58:13,500,10,POS,27697,Praia,490
010903052,2024-10-27T12:59:01,1000,20,POS,16227,Praia,980
010924322,2024-10-27T13:04:14,500,10,POS,28889,Praia,490
010931278,2024-10-27T13:05:12,250,5,POS,27742,Praia,245
010934389,2024-10-27T13:05:32,200,4,POS,25419,Praia,196
010943756,2024-10-27T13:06:03,1000,20,POS,24761,Praia,980
010948436,2024-10-27T13:06:12,1000,20,POS,26044,Praia,980
010953642,2024-10-27T13:07:31,500,10,POS,15016,Praia,490
010954875,2024-10-27T13:08:13,1000,20,POS,26044,Praia,980
010945273,2024-10-27T13:13:06,200,4,POS,28232,Praia,196
010950945,2024-10-27T13:13:16,150,3,POS,30239,Praia,147
010946981,2024-10-27T13:16:51,500,10,POS,22971,Praia,490
010948608,2024-10-27T13:17:40,1000,20,POS,19820,Praia,980
010959070,2024-10-27T13:19:50,300,6,POS,15780,Praia,294
010960501,2024-10-27T13:21:00,200,4,POS,19820,Praia,196
010905266,2024-10-27T13:22:10,200,4,POS,19820,Praia,196
010912004,2024-10-27T13:22:36,250,5,POS,20990,Praia,245
010928269,2024-10-27T13:23:35,500,10,POS,27130,Praia,490
010952525,2024-10-27T13:24:23,250,5,POS,22088,Praia,245
010959385,2024-10-27T13:27:17,500,10,POS,18886,Praia,490
010938457,2024-10-27T13:29:45,150,3,POS,25239,Praia,147
010952392,2024-10-27T13:31:11,500,10,POS,15300,Praia,490
010907525,2024-10-27T13:33:50,700,14,POS,90000160,Praia,686
010952474,2024-10-27T13:35:10,500,10,POS,29603,Praia,490
010957939,2024-10-27T13:35:50,250,5,POS,27409,Praia,245
010962486,2024-10-27T13:37:38,250,5,POS,21107,Praia,245
010927236,2024-10-27T13:40:29,250,5,POS,18296,Praia,245
010947859,2024-10-27T13:42:51,500,10,POS,16469,Praia,490
010917890,2024-10-27T13:45:01,1000,20,POS,27549,Praia,980
010935058,2024-10-27T13:46:08,1150,23,POS,27386,Praia,1127
010935424,2024-10-27T13:48:33,150,3,POS,25858,Praia,147
010951294,2024-10-27T13:48:54,200,4,POS,29749,Praia,196
010958320,2024-10-27T13:52:11,200,4,POS,25419,Praia,196
010950510,2024-10-27T14:01:26,100,2,POS,23127,Praia,98
010961752,2024-10-27T14:04:56,100,2,POS,18283,Praia,98
010961759,2024-10-27T14:05:04,1000,20,POS,19242,Praia,980
010959728,2024-10-27T14:07:54,500,10,POS,19924,Praia,490
010935320,2024-10-27T14:09:59,150,3,POS,12902,Praia,147
010957262,2024-10-27T14:17:27,1000,20,POS,19833,Praia,980
010961445,2024-10-27T14:20:51,150,3,POS,10026,Sal,147
010962410,2024-10-27T14:21:20,250,5,POS,25804,Praia,245
010906555,2024-10-27T14:21:51,260,5,POS,16425,Praia,255
010919321,2024-10-27T14:21:55,500,10,POS,22971,Praia,490
010938647,2024-10-27T14:22:04,500,10,POS,10026,Sal,490
010952179,2024-10-27T14:23:41,500,10,POS,15144,Praia,490
010954722,2024-10-27T14:24:07,260,5,POS,30239,Praia,255
010959923,2024-10-27T14:24:33,260,5,POS,10026,Sal,255
010961555,2024-10-27T14:24:43,150,3,POS,20364,Praia,147
010961721,2024-10-27T14:25:12,500,10,POS,19820,Praia,490
010960882,2024-10-27T14:25:31,150,3,POS,29003,Praia,147
010939111,2024-10-27T14:28:41,150,3,POS,90000208,Praia,147
010940529,2024-10-27T14:28:42,250,5,POS,21454,Praia,245
010942236,2024-10-27T14:29:37,1000,20,POS,18630,Praia,980
010950770,2024-10-27T14:30:33,150,3,POS,30286,Praia,147
010956992,2024-10-27T14:35:25,700,14,POS,90000253,Praia,686
010956686,2024-10-27T14:36:09,300,6,POS,18603,Praia,294
010958851,2024-10-27T14:37:32,500,10,POS,24890,Praia,490
010962973,2024-10-27T14:38:23,1000,20,POS,21540,Praia,980
010919000,2024-10-27T14:39:19,300,6,POS,29000,Praia,294
010942468,2024-10-27T14:39:30,500,10,POS,19306,Praia,490
010961934,2024-10-27T14:41:53,280,6,POS,15991,Praia,274
010961957,2024-10-27T14:45:02,1000,20,POS,16389,Praia,980
010960909,2024-10-27T14:45:34,200,4,POS,21799,Praia,196
010934462,2024-10-27T14:48:29,500,10,POS,29000,Praia,490
010942623,2024-10-27T14:49:17,150,3,POS,6998,Ribeira Grande,147
010955930,2024-10-27T14:53:09,360,7,POS,29023,Praia,353
010959579,2024-10-27T14:53:35,150,3,POS,26995,Praia,147
010962182,2024-10-27T14:54:10,1000,20,POS,16389,Praia,980
010929741,2024-10-27T15:02:20,500,10,POS,15156,Praia,490
010952619,2024-10-27T15:05:31,200,4,POS,9030,Praia,196
010932636,2024-10-27T15:10:36,500,10,POS,22276,Praia,490
010957894,2024-10-27T15:18:45,2000,40,POS,23867,Praia,1960
010957906,2024-10-27T15:24:57,250,5,POS,26826,Praia,245
010871035,2024-10-27T15:27:25,500,10,POS,28713,Praia,490
010939773,2024-10-27T15:28:20,500,10,POS,90000253,Praia,490
010957080,2024-10-27T15:33:51,500,10,POS,19306,Praia,490
010930445,2024-10-27T15:36:29,500,10,POS,90000253,Praia,490
010948573,2024-10-27T15:37:20,500,10,POS,17514,Praia,490
010957114,2024-10-27T15:41:09,500,10,POS,30047,Praia,490
010960445,2024-10-27T15:44:51,250,5,POS,25239,Praia,245
010960750,2024-10-27T15:45:22,500,10,POS,90000253,Praia,490
010897265,2024-10-27T15:45:56,250,5,POS,24839,Praia,245
010931108,2024-10-27T15:47:18,150,3,POS,28974,Praia,147
010927049,2024-10-27T15:49:15,1000,20,POS,20125,Praia,980
010934719,2024-10-27T15:49:23,500,10,POS,90000208,Praia,490
010955620,2024-10-27T15:50:44,150,3,POS,26995,Praia,147
010955753,2024-10-27T15:52:00,1000,20,POS,26044,Praia,980
010957711,2024-10-27T15:52:24,360,7,POS,28868,Praia,353
010895868,2024-10-27T15:55:01,500,10,POS,28627,Praia,490
010956156,2024-10-27T16:06:06,500,10,POS,26652,Praia,490
010888077,2024-10-27T16:12:47,100,2,POS,25402,Praia,98
010914258,2024-10-27T16:14:03,500,10,POS,25654,Praia,490
010951921,2024-10-27T16:15:01,1000,20,POS,27814,Praia,980
010955511,2024-10-27T16:15:09,500,10,POS,26411,Praia,490
010960067,2024-10-27T16:15:47,1000,20,POS,22550,Praia,980
010911109,2024-10-27T16:19:41,200,4,POS,28354,Praia,196
010958208,2024-10-27T16:22:17,500,10,POS,20125,Praia,490
010961924,2024-10-27T16:22:50,1000,20,POS,29445,Praia,980
010960746,2024-10-27T16:24:05,800,16,POS,90000208,Praia,784
010939250,2024-10-27T16:32:31,500,10,POS,16715,Praia,490
010948611,2024-10-27T16:34:31,200,4,POS,22930,Praia,196
010948632,2024-10-27T16:37:02,250,5,POS,14334,Praia,245
010953075,2024-10-27T16:40:05,550,11,POS,23867,Praia,539
010947965,2024-10-27T16:44:18,250,5,POS,30229,Praia,245
010962704,2024-10-27T16:45:22,50,1,POS,23867,Praia,49
010929549,2024-10-27T16:46:21,150,3,POS,22971,Praia,147
010934252,2024-10-27T16:47:00,200,4,POS,90000253,Praia,196
010946148,2024-10-27T16:49:07,150,3,POS,26605,Praia,147
010953779,2024-10-27T16:59:13,350,7,POS,90000208,Praia,343
010955033,2024-10-27T16:59:42,300,6,POS,18630,Praia,294
010956256,2024-10-27T16:59:43,700,14,POS,19820,Praia,686
010958418,2024-10-27T17:00:48,260,5,POS,22120,Praia,255
010914241,2024-10-27T17:00:56,500,10,POS,27578,Praia,490
010954723,2024-10-27T17:04:55,100,2,POS,24272,Praia,98
010956036,2024-10-27T17:06:06,500,10,POS,22447,Praia,490
010958268,2024-10-27T17:06:15,500,10,POS,25325,Praia,490
010958179,2024-10-27T17:06:55,150,3,POS,29478,Praia,147
010929176,2024-10-27T17:08:45,150,3,POS,20719,Praia,147
010962226,2024-10-27T17:12:42,1000,20,POS,19924,Praia,980
010948281,2024-10-27T17:14:36,250,5,POS,22525,Praia,245
010946229,2024-10-27T17:17:38,350,7,POS,28671,Praia,343
010944038,2024-10-27T17:21:44,1000,20,POS,17489,Praia,980
010948357,2024-10-27T17:23:33,250,5,POS,23146,Praia,245
010929286,2024-10-27T17:26:02,610,12,POS,90000160,Praia,598
010955852,2024-10-27T17:27:32,500,10,POS,24839,Praia,490
010959500,2024-10-27T17:30:56,1110,22,POS,18421,Praia,1088
010939942,2024-10-27T17:37:01,200,4,POS,24944,Praia,196
010955210,2024-10-27T17:38:55,1000,20,POS,27365,Praia,980
010956063,2024-10-27T17:39:55,250,5,POS,28726,Praia,245
010961631,2024-10-27T17:40:31,250,5,POS,15991,Praia,245
010952668,2024-10-27T17:44:42,250,5,POS,19328,Praia,245
010956775,2024-10-27T17:46:12,1000,20,POS,27140,Praia,980
010960680,2024-10-27T17:46:47,550,11,POS,90000253,Praia,539
010962273,2024-10-27T17:47:17,500,10,POS,17955,Praia,490
010925604,2024-10-27T17:48:52,1000,20,POS,90000160,Praia,980
010927391,2024-10-27T17:49:01,6000,120,POS,90000253,Praia,5880
010948659,2024-10-27T17:51:46,200,4,POS,28382,Praia,196
010959487,2024-10-27T17:54:44,1000,20,POS,22525,Praia,980
010919303,2024-10-27T17:55:44,200,4,POS,27386,Praia,196
010921702,2024-10-27T17:56:42,250,5,POS,23246,Praia,245
010925988,2024-10-27T17:56:44,150,3,POS,27386,Praia,147
010959284,2024-10-27T18:00:06,520,10,POS,18711,Praia,510
010961070,2024-10-27T18:00:38,1000,20,POS,27105,Praia,980
010941419,2024-10-27T18:02:09,350,7,POS,19924,Praia,343
010947151,2024-10-27T18:02:11,300,6,POS,90000208,Praia,294
010950891,2024-10-27T18:03:26,500,10,POS,18421,Praia,490
010956015,2024-10-27T18:04:13,200,4,POS,19924,Praia,196
010959630,2024-10-27T18:04:32,500,10,POS,20726,Praia,490
010910632,2024-10-27T18:04:51,500,10,POS,141,Sao Domingos,490
010920865,2024-10-27T18:05:11,150,3,POS,19309,Praia,147
010942552,2024-10-27T18:05:44,500,10,POS,20364,Praia,490
010951498,2024-10-27T18:05:46,1200,24,POS,10026,Sal,1176
010957522,2024-10-27T18:06:50,1000,20,POS,19820,Praia,980
010952153,2024-10-27T18:10:18,250,5,POS,19191,Praia,245
010943635,2024-10-27T18:13:27,250,5,POS,16505,Praia,245
010943549,2024-10-27T18:13:28,500,10,POS,28395,Praia,490
010959083,2024-10-27T18:14:33,500,10,POS,7466,Sao Vicente,490
010961868,2024-10-27T18:15:17,1000,20,POS,7466,Sao Vicente,980
010902843,2024-10-27T18:15:37,500,10,POS,30274,Praia,490
010936212,2024-10-27T18:16:09,150,3,POS,11442,Praia,147
010936301,2024-10-27T18:16:10,1000,20,POS,23786,Praia,980
010943861,2024-10-27T18:16:14,150,3,POS,23783,Praia,147
010949582,2024-10-27T18:16:30,500,10,POS,30274,Praia,490
010954463,2024-10-27T18:16:35,300,6,POS,15991,Praia,294
010955339,2024-10-27T18:18:27,270,5,POS,21107,Praia,265
010959158,2024-10-27T18:19:54,500,10,POS,28395,Praia,490
010960848,2024-10-27T18:21:03,250,5,POS,18603,Praia,245
010962045,2024-10-27T18:21:30,220,4,POS,26897,Praia,216
010919380,2024-10-27T18:27:15,280,6,POS,25436,Praia,274
010934148,2024-10-27T18:27:22,150,3,POS,21799,Praia,147
010947379,2024-10-27T18:28:16,500,10,POS,13353,Praia,490
010947981,2024-10-27T18:28:55,350,7,POS,8122,Praia,343
010947929,2024-10-27T18:29:32,250,5,POS,25386,Praia,245
010954788,2024-10-27T18:30:07,610,12,POS,25386,Praia,598
010912727,2024-10-27T18:33:30,150,3,POS,25858,Praia,147
010884948,2024-10-27T18:35:21,500,10,POS,20683,Praia,490
010941529,2024-10-27T18:36:54,500,10,POS,26736,Praia,490
010915293,2024-10-27T18:38:48,150,3,POS,21107,Praia,147
010948182,2024-10-27T18:41:23,150,3,POS,10026,Sal,147
010958249,2024-10-27T18:45:30,150,3,POS,24606,Praia,147
010961803,2024-10-27T18:46:32,100,2,POS,24606,Praia,98
010915928,2024-10-27T18:47:58,250,5,POS,18073,Praia,245
010957011,2024-10-27T18:49:35,1000,20,POS,17489,Praia,980
010959262,2024-10-27T18:49:41,400,8,POS,29687,Praia,392
010917160,2024-10-27T18:52:03,350,7,POS,26652,Praia,343
010957081,2024-10-27T18:56:04,530,11,POS,19916,Praia,519
010960247,2024-10-27T18:56:37,250,5,POS,30216,Praia,245
010959736,2024-10-27T18:56:46,50,1,POS,29082,Praia,49
010962072,2024-10-27T18:58:02,1000,20,POS,22893,Praia,980
010944043,2024-10-27T18:59:01,1000,20,POS,27386,Praia,980
010949826,2024-10-27T19:00:31,500,10,POS,20719,Praia,490
010951443,2024-10-27T19:00:39,500,10,POS,29120,Praia,490
010918473,2024-10-27T19:01:14,300,6,POS,20412,Praia,294
010920237,2024-10-27T19:01:26,700,14,POS,90000253,Praia,686
010959441,2024-10-27T19:04:34,1000,20,POS,27291,Praia,980
010966977,2024-10-27T19:05:58,1000,20,POS,18515,Praia,980
010967285,2024-10-27T19:07:11,500,10,POS,27036,Praia,490
010966184,2024-10-27T19:07:32,1000,20,POS,27164,Praia,980
010966169,2024-10-27T19:08:06,1000,20,POS,25016,Praia,980
010966698,2024-10-27T19:09:41,150,3,POS,16945,Praia,147
010966202,2024-10-27T19:10:08,500,10,POS,5733,Praia,490
010968735,2024-10-27T19:10:57,150,3,POS,18421,Praia,147
010967970,2024-10-27T19:11:55,250,5,POS,14465,Praia,245
010970032,2024-10-27T19:11:58,1000,20,POS,21031,Praia,980
010903657,2024-10-27T19:13:29,110,2,POS,14465,Praia,108
010939607,2024-10-27T19:14:44,500,10,POS,29750,Praia,490
010946924,2024-10-27T19:15:08,250,5,POS,27291,Praia,245
010954899,2024-10-27T19:16:55,250,5,POS,6998,Ribeira Grande,245
010961861,2024-10-27T19:17:49,500,10,POS,21926,Praia,490
010963813,2024-10-27T19:20:33,350,7,POS,27291,Praia,343
010963617,2024-10-27T19:21:24,500,10,POS,10026,Sal,490
010966154,2024-10-27T19:23:43,1000,20,POS,25855,Praia,980
010966420,2024-10-27T19:25:22,150,3,POS,22351,Praia,147
010967054,2024-10-27T19:25:26,300,6,POS,28692,Praia,294
010967088,2024-10-27T19:25:47,300,6,POS,14465,Praia,294
010966352,2024-10-27T19:26:07,300,6,POS,28692,Praia,294
010958856,2024-10-27T19:30:47,250,5,POS,15247,Praia,245
010963440,2024-10-27T19:32:15,300,6,POS,90000253,Praia,294
010916821,2024-10-27T19:35:02,250,5,POS,27291,Praia,245
010921032,2024-10-27T19:35:15,500,10,POS,29524,Praia,490
010940021,2024-10-27T19:36:03,250,5,POS,27291,Praia,245
010964280,2024-10-27T19:45:02,200,4,POS,8545,Praia,196
010965501,2024-10-27T19:45:43,100,2,POS,24597,Praia,98
010964949,2024-10-27T19:45:45,100,2,POS,14465,Praia,98
010969951,2024-10-27T19:48:39,500,10,POS,18421,Praia,490
010933620,2024-10-27T19:51:12,500,10,POS,26693,Praia,490
010948971,2024-10-27T19:51:38,490,10,POS,24839,Praia,480
010955064,2024-10-27T19:52:44,360,7,POS,19849,Praia,353
010957320,2024-10-27T19:53:09,150,3,POS,90000253,Praia,147
010969350,2024-10-27T19:55:39,250,5,POS,15955,Praia,245
010969368,2024-10-27T19:55:41,1000,20,POS,18421,Praia,980
010969304,2024-10-27T19:56:03,1000,20,POS,29880,Praia,980
010969870,2024-10-27T19:56:08,1000,20,POS,30372,Praia,980
010894627,2024-10-27T19:56:21,300,6,POS,19820,Praia,294
010942435,2024-10-27T19:56:57,300,6,POS,25654,Praia,294
010948442,2024-10-27T19:57:06,1000,20,POS,30372,Praia,980
010966399,2024-10-27T20:02:15,200,4,POS,30015,Praia,196
010966128,2024-10-27T20:03:08,300,6,POS,30015,Praia,294
010902891,2024-10-27T20:06:28,500,10,POS,16256,Praia,490
010939158,2024-10-27T20:08:39,490,10,POS,18525,Praia,480
010942137,2024-10-27T20:09:36,500,10,POS,18603,Praia,490
010942291,2024-10-27T20:09:41,250,5,POS,25654,Praia,245
010953939,2024-10-27T20:11:03,150,3,POS,16256,Praia,147
010956995,2024-10-27T20:13:03,300,6,POS,2196,Praia,294
010957126,2024-10-27T20:13:12,150,3,POS,19820,Praia,147
010958422,2024-10-27T20:13:36,200,4,POS,14465,Praia,196
010963991,2024-10-27T20:14:21,200,4,POS,30015,Praia,196
010966338,2024-10-27T20:17:20,200,4,POS,2196,Praia,196
010917880,2024-10-27T20:18:37,1000,20,POS,24840,Praia,980
010933081,2024-10-27T20:21:42,250,5,POS,90000208,Praia,245
010949345,2024-10-27T20:23:03,150,3,POS,28783,Praia,147
010951546,2024-10-27T20:23:54,1000,20,POS,29750,Praia,980
010952711,2024-10-27T20:26:15,150,3,POS,20500,Praia,147
010956153,2024-10-27T20:32:18,980,20,POS,25292,Praia,960
010961398,2024-10-27T20:32:54,1000,20,POS,19820,Praia,980
010963563,2024-10-27T20:32:59,150,3,POS,29448,Praia,147
010963259,2024-10-27T20:34:31,150,3,POS,26996,Praia,147
010963772,2024-10-27T20:35:35,250,5,POS,27748,Praia,245
010963214,2024-10-27T20:35:52,1000,20,POS,21107,Praia,980
010964762,2024-10-27T20:36:12,500,10,POS,90000208,Praia,490
010965640,2024-10-27T20:36:32,500,10,POS,21107,Praia,490
010967439,2024-10-27T20:39:55,150,3,POS,23416,Praia,147
010967705,2024-10-27T20:40:14,500,10,POS,90000208,Praia,490
010959238,2024-10-27T20:45:59,500,10,POS,16184,Praia,490
010965470,2024-10-27T20:47:09,150,3,POS,27291,Praia,147
010964689,2024-10-27T20:47:31,150,3,POS,26335,Praia,147
010966359,2024-10-27T20:51:12,150,3,POS,16307,Praia,147
010966728,2024-10-27T20:52:02,150,3,POS,90000160,Praia,147
010868113,2024-10-27T20:56:54,350,7,POS,28605,Praia,343
010953760,2024-10-27T21:01:01,1000,20,POS,22587,Praia,980
010955641,2024-10-27T21:01:18,300,6,POS,22530,Praia,294
010958803,2024-10-27T21:01:52,250,5,POS,24839,Praia,245
010958480,2024-10-27T21:02:31,300,6,POS,29902,Praia,294
010959524,2024-10-27T21:03:49,1000,20,POS,19924,Praia,980
010961669,2024-10-27T21:04:30,250,5,POS,28628,Praia,245
010961562,2024-10-27T21:04:33,100,2,POS,27386,Praia,98
010960859,2024-10-27T21:04:44,500,10,POS,19924,Praia,490
010965390,2024-10-27T21:06:37,300,6,POS,26414,Praia,294
010966185,2024-10-27T21:07:56,500,10,POS,6585,Sao Domingos,490
010967167,2024-10-27T21:08:49,500,10,POS,6585,Sao Domingos,490
010869787,2024-10-27T21:10:06,1000,20,POS,19306,Praia,980
010904921,2024-10-27T21:10:56,480,10,POS,20364,Praia,470
010922724,2024-10-27T21:11:16,1000,20,POS,27309,Praia,980
010924101,2024-10-27T21:11:24,1000,20,POS,27216,Praia,980
010951776,2024-10-27T21:15:32,250,5,POS,26957,Praia,245
010953521,2024-10-27T21:16:36,250,5,POS,6998,Ribeira Grande,245
010962062,2024-10-27T21:22:58,250,5,POS,23823,Praia,245
010888989,2024-10-27T21:28:40,200,4,POS,4482,Praia,196
010920886,2024-10-27T21:32:03,500,10,POS,24163,Praia,490
010957914,2024-10-27T21:40:40,150,3,POS,18055,Praia,147
010963360,2024-10-27T21:41:09,50,1,POS,28974,Praia,49
010966103,2024-10-27T21:42:27,1000,20,POS,27140,Praia,980
010969311,2024-10-27T21:43:07,550,11,POS,90000208,Praia,539
010940815,2024-10-27T21:45:10,300,6,POS,15162,Praia,294
010948271,2024-10-27T21:48:01,250,5,POS,8371,Praia,245
010964236,2024-10-27T21:49:30,250,5,POS,19306,Praia,245
010964042,2024-10-27T21:51:47,250,5,POS,9500,Sao Vicente,245
010963374,2024-10-27T21:54:01,1000,20,POS,25285,Praia,980
010968212,2024-10-27T21:55:10,200,4,POS,28292,Praia,196
010967898,2024-10-27T21:55:27,500,10,POS,17678,Praia,490
010967588,2024-10-27T21:55:44,1000,20,POS,24839,Praia,980
010968088,2024-10-27T21:56:22,500,10,POS,16389,Praia,490
010967790,2024-10-27T21:56:43,250,5,POS,20624,Praia,245
010968150,2024-10-27T21:59:02,250,5,POS,16944,Praia,245
010968619,2024-10-27T22:00:11,1000,20,POS,23783,Praia,980
010967658,2024-10-27T22:00:58,500,10,POS,23783,Praia,490
010969859,2024-10-27T22:05:26,500,10,POS,27140,Praia,490
010922163,2024-10-27T22:07:54,250,5,POS,23986,Praia,245
010923329,2024-10-27T22:08:58,250,5,POS,22691,Praia,245
010944278,2024-10-27T22:12:30,610,12,POS,22172,Praia,598
010959457,2024-10-27T22:15:39,110,2,POS,90000253,Praia,108
010960803,2024-10-27T22:18:02,500,10,POS,27115,Praia,490
010961303,2024-10-27T22:20:29,250,5,POS,24373,Praia,245
010964092,2024-10-27T22:22:28,250,5,POS,7466,Sao Vicente,245
010963882,2024-10-27T22:23:07,500,10,POS,7869,Praia,490
010963277,2024-10-27T22:24:50,1200,24,POS,21991,Praia,1176
010967566,2024-10-27T22:25:50,500,10,POS,27653,Praia,490
010913222,2024-10-27T22:28:45,360,7,POS,18525,Praia,353
010958030,2024-10-27T22:33:03,200,4,POS,28365,Praia,196
010964673,2024-10-27T22:40:30,350,7,POS,29111,Praia,343
010964563,2024-10-27T22:40:45,150,3,POS,23431,Praia,147
010965318,2024-10-27T22:46:24,155,3,POS,30229,Praia,152
010964620,2024-10-27T23:02:13,250,5,POS,25469,Praia,245
010968154,2024-10-27T23:12:25,150,3,POS,23178,Praia,147
010967949,2024-10-27T23:14:56,500,10,POS,90000253,Praia,490
010930133,2024-10-27T23:24:26,1000,20,POS,15316,Praia,980
010935981,2024-10-27T23:25:34,150,3,POS,16546,Praia,147
010954494,2024-10-27T23:33:23,1000,20,POS,25102,Praia,980
010955670,2024-10-27T23:34:42,1000,20,POS,25102,Praia,980
010963898,2024-10-27T23:46:23,1000,20,POS,18436,Praia,980
010966216,2024-10-27T23:52:50,150,3,POS,22782,Praia,147
010967431,2024-10-27T23:57:34,1000,20,POS,23631,Praia,980
010902895,2024-10-27T00:02:35,250,5,BANCO,0002,,245
010933104,2024-10-27T00:08:53,490,10,BANCO,0002,,480
010937387,2024-10-27T00:11:35,1000,20,BANCO,0008,,980
010948113,2024-10-27T00:21:44,1000,20,BANCO,0002,,980
010951554,2024-10-27T00:24:24,150,3,BANCO,0002,,147
010951226,2024-10-27T00:24:51,500,10,BANCO,0004,,490
010951856,2024-10-27T00:25:51,1000,20,BANCO,0002,,980
010954013,2024-10-27T00:25:51,1000,20,BANCO,0002,,980
010948872,2024-10-27T00:46:16,500,10,BANCO,0002,,490
010949432,2024-10-27T00:47:08,50,1,BANCO,0002,,49
010950754,2024-10-27T00:56:57,1000,20,BANCO,0002,,980
010959328,2024-10-27T00:56:59,500,10,BANCO,0002,,490
010906412,2024-10-27T01:02:15,500,10,BANCO,0002,,490
010927231,2024-10-27T01:11:15,150,3,BANCO,0002,,147
010930383,2024-10-27T01:18:27,250,5,BANCO,0002,,245
010944629,2024-10-27T01:19:22,300,6,BANCO,0002,,294
010944660,2024-10-27T01:24:09,500,10,BANCO,0002,,490
010959552,2024-10-27T02:07:09,150,3,BANCO,0002,,147
010960869,2024-10-27T02:07:33,500,10,BANCO,0002,,490
010961051,2024-10-27T02:13:51,250,5,BANCO,0002,,245
010960877,2024-10-27T02:16:19,150,3,BANCO,0002,,147
010930794,2024-10-27T02:45:47,300,6,BANCO,0002,,294
010941525,2024-10-27T02:46:51,300,6,BANCO,0002,,294
010945944,2024-10-27T03:30:22,200,4,BANCO,0002,,196
010950100,2024-10-27T03:52:57,250,5,BANCO,0002,,245
010949881,2024-10-27T04:17:14,500,10,BANCO,0002,,490
010949360,2024-10-27T04:20:10,500,10,BANCO,0002,,490
010949838,2024-10-27T04:23:15,600,12,BANCO,0003,,588
010953199,2024-10-27T04:28:56,200,4,BANCO,0002,,196
010952812,2024-10-27T04:31:01,100,2,BANCO,0003,,98
010953440,2024-10-27T04:57:47,250,5,BANCO,0003,,245
010957744,2024-10-27T05:12:08,500,10,BANCO,0002,,490
010959473,2024-10-27T05:26:40,500,10,BANCO,0002,,490
010960111,2024-10-27T05:33:15,500,10,BANCO,0003,,490
010959577,2024-10-27T05:48:09,500,10,BANCO,0004,,490
010960902,2024-10-27T05:59:56,1000,20,BANCO,0003,,980
010962281,2024-10-27T06:06:55,500,10,BANCO,0003,,490
010893652,2024-10-27T06:10:03,1000,20,BANCO,0003,,980
010894020,2024-10-27T06:12:47,1000,20,BANCO,0002,,980
010936662,2024-10-27T06:23:19,300,6,BANCO,0003,,294
010942932,2024-10-27T06:29:29,300,6,BANCO,0003,,294
010942462,2024-10-27T06:30:26,500,10,BANCO,0002,,490
010942094,2024-10-27T06:31:49,150,3,BANCO,0002,,147
010951718,2024-10-27T06:35:07,1000,20,BANCO,0005,,980
010953273,2024-10-27T06:38:08,1110,22,BANCO,0002,,1088
010955113,2024-10-27T06:40:48,1000,20,BANCO,0002,,980
010955599,2024-10-27T06:41:23,500,10,BANCO,0002,,490
010954969,2024-10-27T06:44:59,500,10,BANCO,0002,,490
010956975,2024-10-27T06:45:53,500,10,BANCO,0002,,490
010956259,2024-10-27T06:47:10,250,5,BANCO,0003,,245
010958769,2024-10-27T06:49:15,1000,20,BANCO,0003,,980
010957867,2024-10-27T06:52:35,250,5,BANCO,0002,,245
010957372,2024-10-27T06:59:02,250,5,BANCO,0002,,245
010961822,2024-10-27T07:02:54,500,10,BANCO,0002,,490
010960986,2024-10-27T07:05:07,500,10,BANCO,0002,,490
010961982,2024-10-27T07:05:32,150,3,BANCO,0003,,147
010960643,2024-10-27T07:06:59,450,9,BANCO,0002,,441
010961882,2024-10-27T07:05:33,300,6,BANCO,0005,,294
010934390,2024-10-27T07:11:53,1000,20,BANCO,0002,,980
010937637,2024-10-27T07:12:51,500,10,BANCO,0002,,490
010938831,2024-10-27T07:13:15,500,10,BANCO,0004,,490
010941571,2024-10-27T07:13:43,250,5,BANCO,0003,,245
010942706,2024-10-27T07:13:54,200,4,BANCO,0002,,196
010942875,2024-10-27T07:12:13,300,6,BANCO,0005,,294
010942272,2024-10-27T07:14:37,500,10,BANCO,0004,,490
010945602,2024-10-27T07:15:12,250,5,BANCO,0002,,245
010947348,2024-10-27T07:16:48,150,3,BANCO,0003,,147
010947483,2024-10-27T07:17:59,150,3,BANCO,0002,,147
010947711,2024-10-27T07:18:47,250,5,BANCO,0003,,245
010949666,2024-10-27T07:19:29,260,5,BANCO,0002,,255
010951872,2024-10-27T07:23:31,500,10,BANCO,0002,,490
010953792,2024-10-27T07:25:53,250,5,BANCO,0002,,245
010953926,2024-10-27T07:26:49,250,5,BANCO,0002,,245
010954603,2024-10-27T07:27:58,550,11,BANCO,0002,,539
010953985,2024-10-27T07:29:21,250,5,BANCO,0003,,245
010953950,2024-10-27T07:30:26,150,3,BANCO,0005,,147
010957737,2024-10-27T07:34:01,230,5,BANCO,0003,,225
010957368,2024-10-27T07:35:35,200,4,BANCO,0005,,196
010957688,2024-10-27T07:39:41,500,10,BANCO,0002,,490
010958086,2024-10-27T07:39:43,500,10,BANCO,0008,,490
010957634,2024-10-27T07:41:15,350,7,BANCO,0002,,343
010958932,2024-10-27T07:42:05,100,2,BANCO,0003,,98
010959466,2024-10-27T07:41:54,300,6,BANCO,0002,,294
010959609,2024-10-27T07:43:21,500,10,BANCO,0003,,490
010878374,2024-10-27T07:44:18,300,6,BANCO,0003,,294
010901099,2024-10-27T07:45:10,300,6,BANCO,0003,,294
010915936,2024-10-27T07:45:48,500,10,BANCO,0003,,490
010931637,2024-10-27T07:45:54,150,3,BANCO,0002,,147
010940307,2024-10-27T07:49:33,50,1,BANCO,0003,,49
010940791,2024-10-27T07:52:15,500,10,BANCO,0002,,490
010941521,2024-10-27T07:53:22,1000,20,BANCO,0003,,980
010947047,2024-10-27T07:55:03,1000,20,BANCO,0003,,980
010951847,2024-10-27T07:55:58,200,4,BANCO,0003,,196
010956928,2024-10-27T07:59:13,150,3,BANCO,0002,,147
010957731,2024-10-27T08:00:23,350,7,BANCO,0004,,343
010962683,2024-10-27T08:01:54,500,10,BANCO,0003,,490
010962934,2024-10-27T08:01:58,260,5,BANCO,0004,,255
010881013,2024-10-27T08:01:11,400,8,BANCO,0005,,392
010863725,2024-10-27T08:05:09,1000,20,BANCO,0002,,980
010917786,2024-10-27T08:05:33,1000,20,BANCO,0003,,980
010917657,2024-10-27T08:03:16,1000,20,BANCO,0005,,980
010936496,2024-10-27T08:06:31,500,10,BANCO,0003,,490
010936415,2024-10-27T08:06:39,200,4,BANCO,0002,,196
010943258,2024-10-27T08:07:01,500,10,BANCO,0003,,490
010953026,2024-10-27T08:08:44,1000,20,BANCO,0003,,980
010955496,2024-10-27T08:08:56,500,10,BANCO,0002,,490
010954962,2024-10-27T08:09:21,250,5,BANCO,0003,,245
010955423,2024-10-27T08:09:47,500,10,BANCO,0002,,490
010956980,2024-10-27T08:10:35,89,2,BANCO,0002,,87
010957586,2024-10-27T08:11:45,1000,20,BANCO,0003,,980
010961853,2024-10-27T08:14:20,500,10,BANCO,0002,,490
010961726,2024-10-27T08:14:42,200,4,BANCO,0002,,196
010960974,2024-10-27T08:20:59,150,3,BANCO,0002,,147
010962892,2024-10-27T08:23:38,100,2,BANCO,0002,,98
010893426,2024-10-27T09:24:02,150,3,BANCO,0011,,147
010908101,2024-10-27T08:25:00,150,3,BANCO,0002,,147
010919005,2024-10-27T08:25:08,1000,20,BANCO,0002,,980
010925950,2024-10-27T08:26:20,300,6,BANCO,0003,,294
010934940,2024-10-27T08:27:28,300,6,BANCO,0002,,294
010940648,2024-10-27T08:27:35,500,10,BANCO,0002,,490
010941524,2024-10-27T08:27:37,100,2,BANCO,0002,,98
010945145,2024-10-27T08:28:24,250,5,BANCO,0002,,245
010954126,2024-10-27T08:29:58,500,10,BANCO,0003,,490
010954302,2024-10-27T08:31:01,660,13,BANCO,0002,,647
010956002,2024-10-27T08:34:04,1070,21,BANCO,0002,,1049
010956088,2024-10-27T08:34:40,500,10,BANCO,0002,,490
010957045,2024-10-27T08:34:59,500,10,BANCO,0002,,490
010956753,2024-10-27T08:35:33,300,6,BANCO,0003,,294
010959540,2024-10-27T08:33:09,1000,20,BANCO,0005,,980
010959863,2024-10-27T08:35:34,150,3,BANCO,0002,,147
010960988,2024-10-27T08:37:18,150,3,BANCO,0002,,147
010960775,2024-10-27T08:37:45,500,10,BANCO,0003,,490
010961077,2024-10-27T08:37:44,150,3,BANCO,0002,,147
010962693,2024-10-27T08:37:46,260,5,BANCO,0002,,255
010878818,2024-10-27T08:38:20,50,1,BANCO,0002,,49
010927584,2024-10-27T08:39:22,500,10,BANCO,0002,,490
010940483,2024-10-27T08:40:32,300,6,BANCO,0002,,294
010958846,2024-10-27T08:42:37,500,10,BANCO,0008,,490
010959447,2024-10-27T08:46:56,250,5,BANCO,0003,,245
010912037,2024-10-27T08:47:41,500,10,BANCO,0002,,490
010925883,2024-10-27T08:48:09,500,10,BANCO,0002,,490
010927467,2024-10-27T08:48:17,300,6,BANCO,0002,,294
010931742,2024-10-27T08:48:46,250,5,BANCO,0003,,245
010948946,2024-10-27T08:49:14,1000,20,BANCO,0002,,980
010953929,2024-10-27T08:49:58,500,10,BANCO,0003,,490
010955525,2024-10-27T08:50:14,500,10,BANCO,0003,,490
010955448,2024-10-27T08:50:29,1000,20,BANCO,0003,,980
010957117,2024-10-27T08:51:01,150,3,BANCO,0002,,147
010956369,2024-10-27T08:51:27,305,6,BANCO,0002,,299
010956385,2024-10-27T08:53:00,50,1,BANCO,0002,,49
010960497,2024-10-27T08:53:56,150,3,BANCO,0002,,147
010894156,2024-10-27T08:54:32,500,10,BANCO,0004,,490
010933224,2024-10-27T08:56:04,500,10,BANCO,0008,,490
010939759,2024-10-27T08:58:54,1000,20,BANCO,0002,,980
010939794,2024-10-27T08:59:00,1000,20,BANCO,0002,,980
010940205,2024-10-27T08:59:40,250,5,BANCO,0003,,245
010940642,2024-10-27T08:59:24,50,1,BANCO,0002,,49
010950102,2024-10-27T09:01:27,350,7,BANCO,0003,,343
010953969,2024-10-27T09:01:37,250,5,BANCO,0002,,245
010955236,2024-10-27T09:02:05,150,3,BANCO,0003,,147
010955167,2024-10-27T09:02:11,1000,20,BANCO,0003,,980
010956010,2024-10-27T09:02:01,1000,20,BANCO,0004,,980
010955830,2024-10-27T09:02:48,500,10,BANCO,0002,,490
010955829,2024-10-27T09:03:02,500,10,BANCO,0002,,490
010959411,2024-10-27T09:03:24,200,4,BANCO,0002,,196
010961105,2024-10-27T09:03:33,150,3,BANCO,0004,,147
010960517,2024-10-27T09:04:05,1000,20,BANCO,0002,,980
010962426,2024-10-27T09:04:22,1000,20,BANCO,0002,,980
010962684,2024-10-27T09:05:12,1000,20,BANCO,0002,,980
010962804,2024-10-27T09:05:43,250,5,BANCO,0008,,245
010962335,2024-10-27T09:03:45,1000,20,BANCO,0005,,980
010962056,2024-10-27T09:06:06,200,4,BANCO,0002,,196
010918480,2024-10-27T09:08:10,300,6,BANCO,0003,,294
010943043,2024-10-27T09:09:56,500,10,BANCO,0002,,490
010948035,2024-10-27T09:11:18,230,5,BANCO,0003,,225
010949113,2024-10-27T09:11:54,1000,20,BANCO,0002,,980
010954554,2024-10-27T09:13:38,260,5,BANCO,0002,,255
010956150,2024-10-27T09:13:52,100,2,BANCO,0002,,98
010956233,2024-10-27T09:13:54,1000,20,BANCO,0002,,980
010958655,2024-10-27T09:14:45,50,1,BANCO,0002,,49
010959716,2024-10-27T09:15:44,250,5,BANCO,0003,,245
010959547,2024-10-27T09:15:50,1000,20,BANCO,0003,,980
010961421,2024-10-27T09:16:18,250,5,BANCO,0002,,245
010960857,2024-10-27T09:17:10,250,5,BANCO,0004,,245
010960583,2024-10-27T09:18:11,1000,20,BANCO,0003,,980
010962194,2024-10-27T09:19:55,150,3,BANCO,0003,,147
010888244,2024-10-27T09:20:55,140,3,BANCO,0002,,137
010929414,2024-10-27T09:21:13,500,10,BANCO,0002,,490
010938219,2024-10-27T09:22:28,500,10,BANCO,0003,,490
010947237,2024-10-27T09:22:48,150,3,BANCO,0002,,147
010951364,2024-10-27T09:22:58,50,1,BANCO,0002,,49
010954005,2024-10-27T09:23:18,260,5,BANCO,0002,,255
010954061,2024-10-27T09:23:29,500,10,BANCO,0002,,490
010954608,2024-10-27T09:23:39,500,10,BANCO,0002,,490
010954799,2024-10-27T09:23:50,500,10,BANCO,0002,,490
010954521,2024-10-27T09:24:12,500,10,BANCO,0003,,490
010957225,2024-10-27T09:24:06,200,4,BANCO,0002,,196
010957429,2024-10-27T09:25:04,1000,20,BANCO,0003,,980
010958601,2024-10-27T09:22:37,1000,20,BANCO,0005,,980
010959444,2024-10-27T09:24:56,50,1,BANCO,0002,,49
010959737,2024-10-27T09:24:57,150,3,BANCO,0002,,147
010959557,2024-10-27T09:25:20,700,14,BANCO,0003,,686
010931741,2024-10-27T09:26:35,1000,20,BANCO,0003,,980
010948544,2024-10-27T09:27:59,300,6,BANCO,0003,,294
010948374,2024-10-27T09:28:04,2000,40,BANCO,0004,,1960
010948657,2024-10-27T09:28:43,500,10,BANCO,0003,,490
010950121,2024-10-27T09:29:30,510,10,BANCO,0002,,500
010948947,2024-10-27T09:29:58,150,3,BANCO,0003,,147
010952577,2024-10-27T09:29:39,200,4,BANCO,0002,,196
010954949,2024-10-27T09:30:15,160,3,BANCO,0002,,157
010955009,2024-10-27T09:30:21,500,10,BANCO,0002,,490
010955809,2024-10-27T09:30:53,100,2,BANCO,0002,,98
010956285,2024-10-27T09:30:58,500,10,BANCO,0002,,490
010956831,2024-10-27T09:31:04,250,5,BANCO,0002,,245
010960093,2024-10-27T09:31:05,300,6,BANCO,0002,,294
010959498,2024-10-27T09:31:12,500,10,BANCO,0002,,490
010961900,2024-10-27T09:31:36,500,10,BANCO,0003,,490
010961352,2024-10-27T09:31:44,600,12,BANCO,0002,,588
010961244,2024-10-27T09:32:07,150,3,BANCO,0002,,147
010961355,2024-10-27T09:32:44,500,10,BANCO,0003,,490
010897360,2024-10-27T09:32:53,500,10,BANCO,0003,,490
010927058,2024-10-27T09:34:53,500,10,BANCO,0002,,490
010930588,2024-10-27T09:35:00,500,10,BANCO,0002,,490
010940328,2024-10-27T09:35:49,260,5,BANCO,0002,,255
010940158,2024-10-27T09:36:39,500,10,BANCO,0003,,490
010942187,2024-10-27T09:36:30,250,5,BANCO,0002,,245
010943158,2024-10-27T09:37:06,500,10,BANCO,0003,,490
010943572,2024-10-27T09:37:07,500,10,BANCO,0002,,490
010948154,2024-10-27T09:35:04,100,2,BANCO,0005,,98
010951117,2024-10-27T09:38:08,500,10,BANCO,0002,,490
010954051,2024-10-27T09:40:45,150,3,BANCO,0003,,147
010956039,2024-10-27T09:41:07,550,11,BANCO,0004,,539
010958759,2024-10-27T09:41:33,150,3,BANCO,0002,,147
010958289,2024-10-27T09:42:01,1000,20,BANCO,0004,,980
010958020,2024-10-27T09:42:59,1000,20,BANCO,0003,,980
010959324,2024-10-27T09:42:40,1000,20,BANCO,0002,,980
010962710,2024-10-27T09:43:26,281,6,BANCO,0002,,275
010920863,2024-10-27T09:46:03,500,10,BANCO,0008,,490
010931882,2024-10-27T09:46:14,1000,20,BANCO,0002,,980
010936756,2024-10-27T09:47:41,2000,40,BANCO,0008,,1960
010939995,2024-10-27T09:46:41,1000,20,BANCO,0005,,980
010944581,2024-10-27T09:49:21,1000,20,BANCO,0002,,980
010947900,2024-10-27T09:47:40,500,10,BANCO,0005,,490
010949471,2024-10-27T09:50:33,1000,20,BANCO,0004,,980
010950363,2024-10-27T09:51:24,150,3,BANCO,0002,,147
010952011,2024-10-27T09:53:53,500,10,BANCO,0002,,490
010952507,2024-10-27T09:53:18,610,12,BANCO,0005,,598
010952316,2024-10-27T09:53:18,150,3,BANCO,0005,,147
010958531,2024-10-27T09:54:08,100,2,BANCO,0005,,98
010961255,2024-10-27T09:59:52,150,3,BANCO,0002,,147
010960606,2024-10-27T09:59:54,160,3,BANCO,0002,,157
010902050,2024-10-27T10:01:21,1000,20,BANCO,0002,,980
010923080,2024-10-27T10:01:24,500,10,BANCO,0002,,490
010924303,2024-10-27T10:01:24,500,10,BANCO,0002,,490
010926822,2024-10-27T10:01:34,110,2,BANCO,0002,,108
010936795,2024-10-27T10:02:21,150,3,BANCO,0002,,147
010950536,2024-10-27T10:02:55,500,10,BANCO,0008,,490
010953608,2024-10-27T10:03:37,50,1,BANCO,0002,,49
010955646,2024-10-27T10:03:37,250,5,BANCO,0002,,245
010957022,2024-10-27T10:04:57,1000,20,BANCO,0002,,980
010957047,2024-10-27T10:06:07,500,10,BANCO,0002,,490
010955841,2024-10-27T10:06:07,500,10,BANCO,0002,,490
010957214,2024-10-27T10:06:33,500,10,BANCO,0002,,490
010909578,2024-10-27T10:08:17,1000,20,BANCO,0008,,980
010919774,2024-10-27T10:08:31,250,5,BANCO,0002,,245
010937364,2024-10-27T10:08:51,500,10,BANCO,0002,,490
010949278,2024-10-27T10:10:39,200,4,BANCO,0002,,196
010952871,2024-10-27T10:11:09,260,5,BANCO,0002,,255
010952900,2024-10-27T10:11:16,1000,20,BANCO,0002,,980
010952818,2024-10-27T10:11:45,100,2,BANCO,0002,,98
010955607,2024-10-27T10:12:10,500,10,BANCO,0002,,490
010959828,2024-10-27T10:10:26,500,10,BANCO,0005,,490
010962758,2024-10-27T10:13:36,490,10,BANCO,0002,,480
010745880,2024-10-27T10:13:39,150,3,BANCO,0002,,147
010923715,2024-10-27T10:14:15,50,1,BANCO,0002,,49
010933217,2024-10-27T10:14:51,250,5,BANCO,0002,,245
010933299,2024-10-27T10:15:15,300,6,BANCO,0002,,294
010951320,2024-10-27T10:16:51,100,2,BANCO,0002,,98
010954236,2024-10-27T10:17:18,100,2,BANCO,0002,,98
010955952,2024-10-27T10:17:35,1000,20,BANCO,0004,,980
010926884,2024-10-27T10:18:08,50,1,BANCO,0002,,49
010939535,2024-10-27T10:19:18,500,10,BANCO,0002,,490
010941213,2024-10-27T10:20:46,550,11,BANCO,0002,,539
010962324,2024-10-27T10:23:22,500,10,BANCO,0002,,490
010962208,2024-10-27T10:23:22,1000,20,BANCO,0002,,980
010915774,2024-10-27T11:24:38,500,10,BANCO,0011,,490
010956723,2024-10-27T10:26:07,100,2,BANCO,0002,,98
010957470,2024-10-27T10:26:26,150,3,BANCO,0002,,147
010958095,2024-10-27T10:26:35,250,5,BANCO,0002,,245
010959439,2024-10-27T10:26:48,500,10,BANCO,0002,,490
010959543,2024-10-27T10:26:58,505,10,BANCO,0004,,495
010959763,2024-10-27T10:27:08,1000,20,BANCO,0002,,980
010959188,2024-10-27T10:27:22,500,10,BANCO,0002,,490
010959424,2024-10-27T10:25:45,700,14,BANCO,0005,,686
010959143,2024-10-27T10:28:15,505,10,BANCO,0004,,495
010960278,2024-10-27T10:29:12,1000,20,BANCO,0002,,980
010960956,2024-10-27T10:30:36,150,3,BANCO,0002,,147
010960811,2024-10-27T10:28:58,300,6,BANCO,0005,,294
010962188,2024-10-27T10:31:28,65,1,BANCO,0002,,64
010924413,2024-10-27T10:32:07,110,2,BANCO,0008,,108
010926711,2024-10-27T10:32:54,150,3,BANCO,0002,,147
010935598,2024-10-27T10:32:58,248,5,BANCO,0002,,243
010944504,2024-10-27T10:31:02,2000,40,BANCO,0005,,1960
010945151,2024-10-27T10:33:24,500,10,BANCO,0002,,490
010954635,2024-10-27T10:34:48,260,5,BANCO,0002,,255
010955247,2024-10-27T10:35:46,200,4,BANCO,0002,,196
010960744,2024-10-27T10:35:43,490,10,BANCO,0005,,480
010883588,2024-10-27T10:36:18,250,5,BANCO,0005,,245
010935580,2024-10-27T10:39:08,1000,20,BANCO,0002,,980
010936480,2024-10-27T10:37:02,250,5,BANCO,0005,,245
010949734,2024-10-27T10:40:00,1000,20,BANCO,0008,,980
010950808,2024-10-27T10:40:30,500,10,BANCO,0008,,490
010957643,2024-10-27T10:40:58,250,5,BANCO,0004,,245
010959014,2024-10-27T10:41:25,250,5,BANCO,0002,,245
010959139,2024-10-27T10:41:28,200,4,BANCO,0002,,196
010960195,2024-10-27T10:41:30,150,3,BANCO,0004,,147
010907483,2024-10-27T10:39:36,300,6,BANCO,0005,,294
010937063,2024-10-27T10:42:33,500,10,BANCO,0002,,490
010938796,2024-10-27T10:42:47,500,10,BANCO,0008,,490
010940813,2024-10-27T10:42:56,1000,20,BANCO,0002,,980
010941337,2024-10-27T10:43:56,1000,20,BANCO,0002,,980
010945431,2024-10-27T10:44:27,500,10,BANCO,0002,,490
010945065,2024-10-27T10:44:29,150,3,BANCO,0004,,147
010949970,2024-10-27T10:46:08,500,10,BANCO,0002,,490
010950009,2024-10-27T10:46:15,500,10,BANCO,0002,,490
010952495,2024-10-27T10:46:18,450,9,BANCO,0002,,441
010952979,2024-10-27T10:47:18,150,3,BANCO,0002,,147
010954186,2024-10-27T10:48:28,250,5,BANCO,0002,,245
010953874,2024-10-27T10:48:51,500,10,BANCO,0004,,490
010953930,2024-10-27T10:46:52,150,3,BANCO,0005,,147
010954844,2024-10-27T10:50:28,350,7,BANCO,0002,,343
010958070,2024-10-27T10:50:58,1000,20,BANCO,0002,,980
010962882,2024-10-27T10:52:33,150,3,BANCO,0002,,147
010962192,2024-10-27T10:52:44,500,10,BANCO,0002,,490
010896497,2024-10-27T10:53:12,250,5,BANCO,0002,,245
010925242,2024-10-27T10:52:16,150,3,BANCO,0005,,147
010934441,2024-10-27T10:55:47,350,7,BANCO,0002,,343
010951042,2024-10-27T10:56:13,1000,20,BANCO,0002,,980
010955968,2024-10-27T10:56:28,310,6,BANCO,0002,,304
010959668,2024-10-27T10:54:34,200,4,BANCO,0005,,196
010959257,2024-10-27T10:57:18,1000,20,BANCO,0002,,980
010960584,2024-10-27T10:57:58,350,7,BANCO,0002,,343
010908771,2024-10-27T10:59:17,150,3,BANCO,0002,,147
010937058,2024-10-27T11:01:47,500,10,BANCO,0002,,490
010939247,2024-10-27T11:02:11,610,12,BANCO,0002,,598
010941413,2024-10-27T11:02:18,200,4,BANCO,0002,,196
010958288,2024-10-27T11:05:46,500,10,BANCO,0002,,490
010961157,2024-10-27T11:06:13,50,1,BANCO,0002,,49
010883024,2024-10-27T11:06:36,500,10,BANCO,0002,,490
010886173,2024-10-27T11:06:46,300,6,BANCO,0004,,294
010933035,2024-10-27T11:07:34,500,10,BANCO,0002,,490
010944602,2024-10-27T11:07:46,150,3,BANCO,0002,,147
010948965,2024-10-27T11:08:08,280,6,BANCO,0002,,274
010950696,2024-10-27T11:08:58,500,10,BANCO,0002,,490
010960450,2024-10-27T11:10:00,500,10,BANCO,0002,,490
010934677,2024-10-27T11:11:56,1000,20,BANCO,0002,,980
010937293,2024-10-27T11:12:05,500,10,BANCO,0002,,490
010940304,2024-10-27T11:09:57,500,10,BANCO,0005,,490
010940241,2024-10-27T11:12:17,100,2,BANCO,0002,,98
010941416,2024-10-27T11:13:31,430,9,BANCO,0002,,421
010942492,2024-10-27T11:13:46,1000,20,BANCO,0002,,980
010946134,2024-10-27T11:15:22,200,4,BANCO,0002,,196
010952256,2024-10-27T11:16:35,250,5,BANCO,0002,,245
010954277,2024-10-27T11:16:53,500,10,BANCO,0002,,490
010954621,2024-10-27T11:17:08,300,6,BANCO,0002,,294
010956494,2024-10-27T11:17:17,1000,20,BANCO,0002,,980
010956343,2024-10-27T11:17:37,50,1,BANCO,0002,,49
010962076,2024-10-27T11:18:47,1150,23,BANCO,0002,,1127
010918889,2024-10-27T11:20:01,200,4,BANCO,0002,,196
010931727,2024-10-27T11:20:05,90,2,BANCO,0002,,88
010931236,2024-10-27T11:20:08,500,10,BANCO,0004,,490
010944552,2024-10-27T11:20:22,150,3,BANCO,0002,,147
010943381,2024-10-27T11:20:30,250,5,BANCO,0002,,245
010948712,2024-10-27T11:21:43,600,12,BANCO,0002,,588
010951532,2024-10-27T11:22:00,350,7,BANCO,0002,,343
010955709,2024-10-27T11:23:35,350,7,BANCO,0002,,343
010958148,2024-10-27T11:25:10,1000,20,BANCO,0002,,980
010957556,2024-10-27T11:25:30,250,5,BANCO,0002,,245
010923172,2024-10-27T11:27:02,1000,20,BANCO,0002,,980
010929825,2024-10-27T11:27:40,300,6,BANCO,0002,,294
010940068,2024-10-27T11:28:04,150,3,BANCO,0008,,147
010940213,2024-10-27T11:28:07,1000,20,BANCO,0002,,980
010941253,2024-10-27T11:26:23,1000,20,BANCO,0005,,980
010944223,2024-10-27T11:29:02,100,2,BANCO,0002,,98
010958164,2024-10-27T11:30:24,70,1,BANCO,0002,,69
010890605,2024-10-27T11:31:59,500,10,BANCO,0002,,490
010947070,2024-10-27T11:32:58,560,11,BANCO,0004,,549
010950570,2024-10-27T11:33:49,50,1,BANCO,0002,,49
010956401,2024-10-27T11:33:50,700,14,BANCO,0002,,686
010959631,2024-10-27T11:34:21,150,3,BANCO,0002,,147
010958989,2024-10-27T11:34:28,500,10,BANCO,0002,,490
010905486,2024-10-27T11:34:43,200,4,BANCO,0008,,196
010918317,2024-10-27T11:34:47,500,10,BANCO,0002,,490
010927295,2024-10-27T11:36:54,1000,20,BANCO,0002,,980
010931732,2024-10-27T11:37:06,150,3,BANCO,0002,,147
010940757,2024-10-27T11:39:23,150,3,BANCO,0002,,147
010955667,2024-10-27T11:39:04,200,4,BANCO,0005,,196
010955754,2024-10-27T11:41:20,100,2,BANCO,0002,,98
010960997,2024-10-27T11:42:05,250,5,BANCO,0002,,245
010899608,2024-10-27T11:45:25,550,11,BANCO,0002,,539
010928371,2024-10-27T11:47:30,500,10,BANCO,0002,,490
010946409,2024-10-27T11:49:12,200,4,BANCO,0002,,196
010952652,2024-10-27T11:50:53,500,10,BANCO,0002,,490
010955452,2024-10-27T11:50:55,150,3,BANCO,0004,,147
010957034,2024-10-27T11:53:08,500,10,BANCO,0002,,490
010959724,2024-10-27T11:53:08,1100,22,BANCO,0002,,1078
010961290,2024-10-27T11:53:39,500,10,BANCO,0002,,490
010961034,2024-10-27T11:54:24,200,4,BANCO,0002,,196
010879055,2024-10-27T11:54:31,150,3,BANCO,0002,,147
010918014,2024-10-27T11:55:06,150,3,BANCO,0002,,147
010950118,2024-10-27T11:56:59,500,10,BANCO,0002,,490
010952294,2024-10-27T11:57:00,250,5,BANCO,0002,,245
010960438,2024-10-27T11:57:26,1000,20,BANCO,0002,,980
010902901,2024-10-27T11:58:44,150,3,BANCO,0002,,147
010925385,2024-10-27T11:59:08,500,10,BANCO,0002,,490
010932694,2024-10-27T11:59:33,350,7,BANCO,0002,,343
010949633,2024-10-27T12:02:07,1500,30,BANCO,0002,,1470
010955545,2024-10-27T12:02:12,250,5,BANCO,0002,,245
010958455,2024-10-27T12:02:19,150,3,BANCO,0002,,147
010959333,2024-10-27T12:02:57,500,10,BANCO,0002,,490
010923977,2024-10-27T12:04:11,50,1,BANCO,0002,,49
010931511,2024-10-27T12:04:31,60,1,BANCO,0002,,59
010951998,2024-10-27T12:06:26,500,10,BANCO,0002,,490
010958205,2024-10-27T12:06:54,250,5,BANCO,0008,,245
010927832,2024-10-27T12:11:07,1000,20,BANCO,0002,,980
010939023,2024-10-27T12:11:35,500,10,BANCO,0002,,490
010942163,2024-10-27T12:11:55,500,10,BANCO,0002,,490
010941978,2024-10-27T12:10:00,500,10,BANCO,0005,,490
010949488,2024-10-27T12:12:56,70,1,BANCO,0002,,69
010955020,2024-10-27T12:13:28,300,6,BANCO,0002,,294
010955583,2024-10-27T12:14:15,250,5,BANCO,0002,,245
010956701,2024-10-27T12:12:10,300,6,BANCO,0005,,294
010956763,2024-10-27T12:14:25,500,10,BANCO,0008,,490
010956877,2024-10-27T12:12:11,250,5,BANCO,0005,,245
010958747,2024-10-27T12:15:28,1000,20,BANCO,0002,,980
010958501,2024-10-27T12:15:32,1000,20,BANCO,0002,,980
010958416,2024-10-27T13:16:06,550,11,BANCO,0011,,539
010960576,2024-10-27T12:16:36,500,10,BANCO,0002,,490
010960767,2024-10-27T12:16:37,500,10,BANCO,0002,,490
010961122,2024-10-27T12:17:08,500,10,BANCO,0002,,490
010961560,2024-10-27T12:16:15,150,3,BANCO,0005,,147
010877557,2024-10-27T12:18:35,500,10,BANCO,0002,,490
010931575,2024-10-27T12:18:42,250,5,BANCO,0002,,245
010931170,2024-10-27T12:18:57,250,5,BANCO,0002,,245
010946787,2024-10-27T12:19:49,150,3,BANCO,0002,,147
010951836,2024-10-27T12:21:26,500,10,BANCO,0002,,490
010957198,2024-10-27T12:23:00,500,10,BANCO,0002,,490
010912381,2024-10-27T12:24:42,250,5,BANCO,0002,,245
010926954,2024-10-27T12:24:55,150,3,BANCO,0002,,147
010948583,2024-10-27T12:26:33,150,3,BANCO,0002,,147
010949018,2024-10-27T12:26:42,150,3,BANCO,0004,,147
010949532,2024-10-27T12:24:42,500,10,BANCO,0005,,490
010953553,2024-10-27T12:27:45,1000,20,BANCO,0002,,980
010955282,2024-10-27T12:29:06,500,10,BANCO,0002,,490
010958808,2024-10-27T12:27:33,500,10,BANCO,0005,,490
010957756,2024-10-27T12:29:45,160,3,BANCO,0002,,157
010957483,2024-10-27T12:30:21,150,3,BANCO,0002,,147
010959085,2024-10-27T12:31:19,600,12,BANCO,0002,,588
010959361,2024-10-27T12:29:15,1000,20,BANCO,0005,,980
010959760,2024-10-27T12:32:30,500,10,BANCO,0002,,490
010959456,2024-10-27T12:34:12,1000,20,BANCO,0002,,980
010961262,2024-10-27T12:34:23,250,5,BANCO,0002,,245
010961615,2024-10-27T12:32:26,1000,20,BANCO,0005,,980
010962705,2024-10-27T12:35:56,100,2,BANCO,0002,,98
010962343,2024-10-27T12:36:47,60,1,BANCO,0002,,59
010908665,2024-10-27T12:37:25,250,5,BANCO,0002,,245
010912060,2024-10-27T12:37:44,500,10,BANCO,0002,,490
010932157,2024-10-27T12:35:42,500,10,BANCO,0005,,490
010939426,2024-10-27T12:38:36,1000,20,BANCO,0002,,980
010950593,2024-10-27T12:39:25,250,5,BANCO,0002,,245
010952186,2024-10-27T12:39:41,500,10,BANCO,0002,,490
010962082,2024-10-27T12:40:49,50,1,BANCO,0002,,49
010896620,2024-10-27T12:42:18,140,3,BANCO,0002,,137
010911086,2024-10-27T12:42:33,550,11,BANCO,0002,,539
010938814,2024-10-27T12:43:16,4000,80,BANCO,0002,,3920
010938226,2024-10-27T12:44:16,150,3,BANCO,0002,,147
010941020,2024-10-27T12:44:32,500,10,BANCO,0002,,490
010954918,2024-10-27T12:44:58,500,10,BANCO,0002,,490
010958284,2024-10-27T12:45:43,300,6,BANCO,0008,,294
010958500,2024-10-27T12:45:43,600,12,BANCO,0002,,588
010959678,2024-10-27T12:47:04,250,5,BANCO,0002,,245
010960763,2024-10-27T12:47:13,155,3,BANCO,0004,,152
010962112,2024-10-27T12:47:13,500,10,BANCO,0002,,490
010962660,2024-10-27T12:47:14,150,3,BANCO,0002,,147
010896998,2024-10-27T12:47:24,250,5,BANCO,0002,,245
010921137,2024-10-27T12:47:36,500,10,BANCO,0002,,490
010954749,2024-10-27T12:50:37,500,10,BANCO,0008,,490
010962528,2024-10-27T12:50:50,250,5,BANCO,0002,,245
010897460,2024-10-27T12:50:58,150,3,BANCO,0002,,147
010925486,2024-10-27T12:49:43,700,14,BANCO,0005,,686
010938954,2024-10-27T12:52:20,1100,22,BANCO,0002,,1078
010939141,2024-10-27T12:53:14,250,5,BANCO,0002,,245
010950862,2024-10-27T12:54:07,500,10,BANCO,0002,,490
010951148,2024-10-27T12:54:08,350,7,BANCO,0002,,343
010950601,2024-10-27T12:54:21,250,5,BANCO,0004,,245
010955663,2024-10-27T12:54:39,150,3,BANCO,0002,,147
010961001,2024-10-27T12:57:40,1000,20,BANCO,0002,,980
010962615,2024-10-27T12:57:57,50,1,BANCO,0004,,49
010962904,2024-10-27T12:58:33,150,3,BANCO,0002,,147
010934216,2024-10-27T13:00:30,500,10,BANCO,0002,,490
010947691,2024-10-27T13:01:11,500,10,BANCO,0002,,490
010957440,2024-10-27T13:02:44,500,10,BANCO,0002,,490
010959147,2024-10-27T13:03:03,1000,20,BANCO,0002,,980
010962331,2024-10-27T13:03:32,350,7,BANCO,0002,,343
010912444,2024-10-27T13:03:44,500,10,BANCO,0002,,490
010914299,2024-10-27T13:03:53,150,3,BANCO,0002,,147
010924506,2024-10-27T13:04:57,250,5,BANCO,0002,,245
010949465,2024-10-27T13:06:51,1000,20,BANCO,0002,,980
010951407,2024-10-27T13:07:06,260,5,BANCO,0002,,255
010951661,2024-10-27T13:07:11,100,2,BANCO,0002,,98
010955536,2024-10-27T13:07:35,500,10,BANCO,0004,,490
010959276,2024-10-27T13:08:46,1000,20,BANCO,0002,,980
010960153,2024-10-27T13:08:49,1000,20,BANCO,0002,,980
010959384,2024-10-27T13:09:16,390,8,BANCO,0002,,382
010960323,2024-10-27T13:09:54,150,3,BANCO,0002,,147
010959375,2024-10-27T13:09:57,1000,20,BANCO,0002,,980
010960007,2024-10-27T13:11:17,500,10,BANCO,0002,,490
010960703,2024-10-27T13:11:39,500,10,BANCO,0002,,490
010903723,2024-10-27T13:12:23,500,10,BANCO,0002,,490
010952143,2024-10-27T13:13:51,1000,20,BANCO,0002,,980
010959740,2024-10-27T13:14:12,110,2,BANCO,0002,,108
010962218,2024-10-27T13:14:33,80,2,BANCO,0002,,78
010932630,2024-10-27T13:15:29,150,3,BANCO,0002,,147
010941728,2024-10-27T13:16:14,150,3,BANCO,0002,,147
010947652,2024-10-27T13:17:00,50,1,BANCO,0002,,49
010955551,2024-10-27T13:18:24,500,10,BANCO,0002,,490
010956148,2024-10-27T13:18:36,260,5,BANCO,0004,,255
010960447,2024-10-27T13:19:00,50,1,BANCO,0004,,49
010959873,2024-10-27T13:19:16,250,5,BANCO,0002,,245
010962576,2024-10-27T13:21:33,50,1,BANCO,0002,,49
010962811,2024-10-27T13:21:49,200,4,BANCO,0002,,196
010922997,2024-10-27T13:23:25,1000,20,BANCO,0002,,980
010932834,2024-10-27T13:23:53,350,7,BANCO,0002,,343
010953286,2024-10-27T13:25:00,111,2,BANCO,0002,,109
010952318,2024-10-27T13:25:40,500,10,BANCO,0002,,490
010954841,2024-10-27T13:26:37,100,2,BANCO,0002,,98
010957211,2024-10-27T13:26:57,500,10,BANCO,0002,,490
010901342,2024-10-27T13:27:28,700,14,BANCO,0008,,686
010911159,2024-10-27T13:27:35,150,3,BANCO,0002,,147
010920131,2024-10-27T13:27:38,250,5,BANCO,0002,,245
010936066,2024-10-27T13:28:26,500,10,BANCO,0002,,490
010939573,2024-10-27T13:29:49,250,5,BANCO,0008,,245
010950637,2024-10-27T13:30:58,1000,20,BANCO,0004,,980
010955225,2024-10-27T13:31:47,150,3,BANCO,0002,,147
010956152,2024-10-27T13:31:56,500,10,BANCO,0002,,490
010956651,2024-10-27T13:32:04,500,10,BANCO,0008,,490
010956301,2024-10-27T13:32:05,500,10,BANCO,0004,,490
010959913,2024-10-27T13:30:18,500,10,BANCO,0005,,490
010962445,2024-10-27T13:32:42,250,5,BANCO,0002,,245
010890542,2024-10-27T13:33:44,250,5,BANCO,0002,,245
010938314,2024-10-27T13:34:10,1000,20,BANCO,0002,,980
010940987,2024-10-27T13:32:51,500,10,BANCO,0005,,490
010957171,2024-10-27T13:35:20,700,14,BANCO,0008,,686
010957371,2024-10-27T13:35:26,500,10,BANCO,0002,,490
010962180,2024-10-27T13:37:37,1000,20,BANCO,0002,,980
010893904,2024-10-27T13:35:58,160,3,BANCO,0005,,157
010920525,2024-10-27T13:36:17,500,10,BANCO,0005,,490
010933811,2024-10-27T13:40:35,1000,20,BANCO,0002,,980
010935578,2024-10-27T13:41:13,250,5,BANCO,0002,,245
010935969,2024-10-27T13:41:29,150,3,BANCO,0002,,147
010935336,2024-10-27T13:41:41,120,2,BANCO,0002,,118
010935005,2024-10-27T13:41:52,500,10,BANCO,0002,,490
010935994,2024-10-27T13:41:53,300,6,BANCO,0002,,294
010935117,2024-10-27T13:41:57,1000,20,BANCO,0008,,980
010938588,2024-10-27T13:42:03,300,6,BANCO,0002,,294
010939375,2024-10-27T13:42:12,150,3,BANCO,0002,,147
010941633,2024-10-27T13:42:38,150,3,BANCO,0002,,147
010945237,2024-10-27T13:42:50,80,2,BANCO,0002,,78
010949557,2024-10-27T13:42:53,600,12,BANCO,0002,,588
010952582,2024-10-27T13:43:07,500,10,BANCO,0002,,490
010954169,2024-10-27T13:43:08,350,7,BANCO,0002,,343
010955346,2024-10-27T13:43:26,400,8,BANCO,0004,,392
010960948,2024-10-27T13:43:51,150,3,BANCO,0002,,147
010961048,2024-10-27T13:44:08,500,10,BANCO,0002,,490
010961955,2024-10-27T13:44:39,230,5,BANCO,0002,,225
010962128,2024-10-27T13:44:44,500,10,BANCO,0002,,490
010926020,2024-10-27T13:45:42,150,3,BANCO,0002,,147
010941452,2024-10-27T13:46:17,500,10,BANCO,0002,,490
010955106,2024-10-27T13:46:59,1000,20,BANCO,0002,,980
010955477,2024-10-27T13:44:49,1000,20,BANCO,0005,,980
010957089,2024-10-27T13:47:11,1000,20,BANCO,0002,,980
010956859,2024-10-27T13:47:21,200,4,BANCO,0002,,196
010956198,2024-10-27T13:47:28,1000,20,BANCO,0002,,980
010957094,2024-10-27T13:48:24,500,10,BANCO,0002,,490
010881479,2024-10-27T13:48:31,500,10,BANCO,0002,,490
010911309,2024-10-27T13:48:31,1000,20,BANCO,0002,,980
010947589,2024-10-27T13:48:53,500,10,BANCO,0002,,490
010951767,2024-10-27T13:49:56,250,5,BANCO,0002,,245
010952592,2024-10-27T13:50:13,160,3,BANCO,0002,,157
010952129,2024-10-27T13:50:19,250,5,BANCO,0002,,245
010957431,2024-10-27T13:51:58,400,8,BANCO,0002,,392
010958088,2024-10-27T13:52:09,50,1,BANCO,0002,,49
010959248,2024-10-27T13:52:21,500,10,BANCO,0002,,490
010959554,2024-10-27T13:52:58,1000,20,BANCO,0002,,980
010959397,2024-10-27T13:53:16,500,10,BANCO,0002,,490
010914281,2024-10-27T13:56:17,200,4,BANCO,0002,,196
010930128,2024-10-27T13:56:27,500,10,BANCO,0002,,490
010954850,2024-10-27T13:57:21,500,10,BANCO,0002,,490
010958676,2024-10-27T13:57:37,150,3,BANCO,0002,,147
010925661,2024-10-27T13:58:11,1500,30,BANCO,0004,,1470
010939222,2024-10-27T13:58:37,250,5,BANCO,0002,,245
010950433,2024-10-27T13:58:16,300,6,BANCO,0005,,294
010950254,2024-10-27T14:00:24,50,1,BANCO,0002,,49
010951462,2024-10-27T14:00:32,300,6,BANCO,0002,,294
010950228,2024-10-27T14:01:16,1000,20,BANCO,0002,,980
010953256,2024-10-27T14:02:29,500,10,BANCO,0004,,490
010954561,2024-10-27T14:02:39,300,6,BANCO,0002,,294
010958545,2024-10-27T14:02:57,700,14,BANCO,0004,,686
010961431,2024-10-27T14:03:09,750,15,BANCO,0002,,735
010960813,2024-10-27T14:03:26,150,3,BANCO,0002,,147
010961206,2024-10-27T14:03:54,200,4,BANCO,0008,,196
010961537,2024-10-27T14:04:14,500,10,BANCO,0004,,490
010961103,2024-10-27T14:02:39,150,3,BANCO,0005,,147
010960762,2024-10-27T14:05:41,150,3,BANCO,0004,,147
010912635,2024-10-27T14:05:59,200,4,BANCO,0002,,196
010951962,2024-10-27T14:06:53,500,10,BANCO,0002,,490
010958539,2024-10-27T14:07:22,1000,20,BANCO,0008,,980
010958534,2024-10-27T14:07:23,1000,20,BANCO,0002,,980
010959448,2024-10-27T14:09:05,250,5,BANCO,0002,,245
010962429,2024-10-27T14:09:10,150,3,BANCO,0002,,147
010918763,2024-10-27T14:09:15,50,1,BANCO,0002,,49
010944397,2024-10-27T14:10:07,750,15,BANCO,0002,,735
010945719,2024-10-27T14:10:10,159,3,BANCO,0002,,156
010945534,2024-10-27T14:11:12,300,6,BANCO,0002,,294
010952203,2024-10-27T14:10:21,1000,20,BANCO,0005,,980
010952043,2024-10-27T14:12:43,250,5,BANCO,0002,,245
010952461,2024-10-27T14:12:55,100,2,BANCO,0002,,98
010953485,2024-10-27T14:13:16,190,4,BANCO,0002,,186
010953442,2024-10-27T14:13:24,150,3,BANCO,0002,,147
010878541,2024-10-27T14:12:32,700,14,BANCO,0005,,686
010895085,2024-10-27T14:14:56,1000,20,BANCO,0002,,980
010938642,2024-10-27T14:16:53,1000,20,BANCO,0002,,980
010946159,2024-10-27T14:17:13,50,1,BANCO,0002,,49
010955819,2024-10-27T14:17:25,500,10,BANCO,0002,,490
010958016,2024-10-27T14:18:38,500,10,BANCO,0002,,490
010958687,2024-10-27T14:18:39,500,10,BANCO,0002,,490
010961825,2024-10-27T14:18:58,250,5,BANCO,0002,,245
010960527,2024-10-27T14:20:16,310,6,BANCO,0002,,304
010961367,2024-10-27T14:20:30,200,4,BANCO,0002,,196
010960846,2024-10-27T14:20:41,260,5,BANCO,0002,,255
010960971,2024-10-27T14:20:52,250,5,BANCO,0002,,245
010962428,2024-10-27T14:21:42,500,10,BANCO,0002,,490
010939834,2024-10-27T14:22:14,600,12,BANCO,0002,,588
010942617,2024-10-27T14:20:23,260,5,BANCO,0005,,255
010953923,2024-10-27T14:24:19,200,4,BANCO,0002,,196
010955539,2024-10-27T14:24:21,200,4,BANCO,0002,,196
010955812,2024-10-27T14:24:28,200,4,BANCO,0002,,196
010959037,2024-10-27T14:24:36,50,1,BANCO,0002,,49
010961481,2024-10-27T14:24:44,1100,22,BANCO,0002,,1078
010960801,2024-10-27T14:24:58,1200,24,BANCO,0004,,1176
010961593,2024-10-27T14:25:14,50,1,BANCO,0002,,49
010904626,2024-10-27T14:26:39,200,4,BANCO,0002,,196
010913542,2024-10-27T14:26:49,550,11,BANCO,0002,,539
010918649,2024-10-27T14:27:31,500,10,BANCO,0002,,490
010931378,2024-10-27T14:27:54,150,3,BANCO,0008,,147
010941042,2024-10-27T14:28:47,1000,20,BANCO,0002,,980
010949727,2024-10-27T14:29:42,150,3,BANCO,0002,,147
010905566,2024-10-27T14:31:11,500,10,BANCO,0002,,490
010916123,2024-10-27T14:31:14,100,2,BANCO,0002,,98
010945171,2024-10-27T14:32:00,300,6,BANCO,0002,,294
010955640,2024-10-27T14:32:16,300,6,BANCO,0002,,294
010955360,2024-10-27T14:32:47,150,3,BANCO,0002,,147
010955133,2024-10-27T14:34:49,250,5,BANCO,0002,,245
010956017,2024-10-27T14:36:07,260,5,BANCO,0002,,255
010955875,2024-10-27T14:36:07,500,10,BANCO,0002,,490
010956779,2024-10-27T14:34:19,1500,30,BANCO,0005,,1470
010959926,2024-10-27T14:38:04,1000,20,BANCO,0002,,980
010962236,2024-10-27T14:38:05,150,3,BANCO,0002,,147
010918980,2024-10-27T14:39:21,200,4,BANCO,0002,,196
010922099,2024-10-27T14:39:28,50,1,BANCO,0002,,49
010948561,2024-10-27T14:40:16,150,3,BANCO,0002,,147
010956573,2024-10-27T14:40:56,500,10,BANCO,0002,,490
010958840,2024-10-27T14:40:58,500,10,BANCO,0002,,490
010957435,2024-10-27T14:41:02,520,10,BANCO,0002,,510
010957397,2024-10-27T14:41:12,250,5,BANCO,0002,,245
010959568,2024-10-27T14:41:29,50,1,BANCO,0004,,49
010960805,2024-10-27T14:41:29,500,10,BANCO,0002,,490
010948138,2024-10-27T14:43:02,100,2,BANCO,0002,,98
010949027,2024-10-27T14:43:34,300,6,BANCO,0002,,294
010949208,2024-10-27T14:44:02,50,1,BANCO,0004,,49
010950834,2024-10-27T14:44:45,500,10,BANCO,0002,,490
010958059,2024-10-27T14:42:46,200,4,BANCO,0005,,196
010961704,2024-10-27T14:45:25,500,10,BANCO,0002,,490
010962360,2024-10-27T14:46:17,100,2,BANCO,0002,,98
010962470,2024-10-27T14:46:45,500,10,BANCO,0002,,490
010899345,2024-10-27T14:47:08,90,2,BANCO,0002,,88
010923863,2024-10-27T14:48:16,150,3,BANCO,0002,,147
010942697,2024-10-27T14:48:48,500,10,BANCO,0002,,490
010942225,2024-10-27T14:48:57,1000,20,BANCO,0002,,980
010948432,2024-10-27T14:49:23,250,5,BANCO,0002,,245
010947961,2024-10-27T14:50:31,110,2,BANCO,0002,,108
010954369,2024-10-27T14:51:37,250,5,BANCO,0002,,245
010956308,2024-10-27T14:50:01,1000,20,BANCO,0005,,980
010956274,2024-10-27T14:53:00,150,3,BANCO,0002,,147
010961614,2024-10-27T14:53:47,1000,20,BANCO,0004,,980
010938580,2024-10-27T14:54:34,150,3,BANCO,0002,,147
010952257,2024-10-27T14:55:52,150,3,BANCO,0002,,147
010955046,2024-10-27T14:56:57,150,3,BANCO,0002,,147
010958508,2024-10-27T14:58:15,400,8,BANCO,0002,,392
010961140,2024-10-27T14:58:24,600,12,BANCO,0002,,588
010873019,2024-10-27T14:59:18,150,3,BANCO,0002,,147
010898859,2024-10-27T14:59:21,50,1,BANCO,0002,,49
010910663,2024-10-27T14:58:51,150,3,BANCO,0005,,147
010931593,2024-10-27T15:02:10,100,2,BANCO,0002,,98
010946553,2024-10-27T15:02:47,150,3,BANCO,0002,,147
010949930,2024-10-27T15:03:24,1000,20,BANCO,0008,,980
010950677,2024-10-27T15:04:36,150,3,BANCO,0002,,147
010920653,2024-10-27T15:07:56,1000,20,BANCO,0002,,980
010920064,2024-10-27T15:09:00,500,10,BANCO,0002,,490
010932799,2024-10-27T15:10:00,505,10,BANCO,0002,,495
010936655,2024-10-27T15:11:20,1000,20,BANCO,0008,,980
010940140,2024-10-27T15:11:30,500,10,BANCO,0002,,490
010941656,2024-10-27T15:11:58,500,10,BANCO,0002,,490
010956250,2024-10-27T15:14:30,700,14,BANCO,0002,,686
010958271,2024-10-27T15:18:32,150,3,BANCO,0002,,147
010957557,2024-10-27T15:19:26,505,10,BANCO,0002,,495
010961322,2024-10-27T15:19:43,50,1,BANCO,0002,,49
010961769,2024-10-27T15:20:02,250,5,BANCO,0002,,245
010865325,2024-10-27T15:20:05,500,10,BANCO,0004,,490
010926179,2024-10-27T15:20:11,500,10,BANCO,0002,,490
010944582,2024-10-27T15:20:44,500,10,BANCO,0002,,490
010944726,2024-10-27T15:21:18,500,10,BANCO,0002,,490
010946586,2024-10-27T15:22:49,200,4,BANCO,0002,,196
010948511,2024-10-27T15:22:52,500,10,BANCO,0008,,490
010956850,2024-10-27T15:23:35,610,12,BANCO,0002,,598
010957896,2024-10-27T15:24:00,100,2,BANCO,0002,,98
010958598,2024-10-27T15:24:14,500,10,BANCO,0002,,490
010960307,2024-10-27T15:25:09,1000,20,BANCO,0008,,980
010902821,2024-10-27T15:27:43,200,4,BANCO,0008,,196
010939957,2024-10-27T15:28:26,100,2,BANCO,0002,,98
010947575,2024-10-27T15:28:41,100,2,BANCO,0002,,98
010948986,2024-10-27T15:29:06,1000,20,BANCO,0002,,980
010949634,2024-10-27T15:29:45,150,3,BANCO,0002,,147
010951469,2024-10-27T15:30:13,200,4,BANCO,0002,,196
010951430,2024-10-27T15:30:37,500,10,BANCO,0002,,490
010951632,2024-10-27T15:31:58,250,5,BANCO,0002,,245
010954375,2024-10-27T15:32:24,1000,20,BANCO,0002,,980
010956210,2024-10-27T15:32:46,300,6,BANCO,0002,,294
010956307,2024-10-27T15:33:39,150,3,BANCO,0002,,147
010959341,2024-10-27T15:34:18,150,3,BANCO,0002,,147
010960130,2024-10-27T15:32:56,1000,20,BANCO,0005,,980
010959181,2024-10-27T15:35:29,500,10,BANCO,0002,,490
010911114,2024-10-27T15:35:34,500,10,BANCO,0002,,490
010915956,2024-10-27T15:35:37,250,5,BANCO,0002,,245
010936975,2024-10-27T15:37:12,500,10,BANCO,0004,,490
010949381,2024-10-27T15:37:54,250,5,BANCO,0002,,245
010951221,2024-10-27T15:38:05,500,10,BANCO,0002,,490
010951916,2024-10-27T15:38:24,510,10,BANCO,0002,,500
010952425,2024-10-27T15:38:58,350,7,BANCO,0002,,343
010953784,2024-10-27T15:40:35,1000,20,BANCO,0002,,980
010955679,2024-10-27T15:41:01,500,10,BANCO,0002,,490
010956838,2024-10-27T15:41:18,500,10,BANCO,0002,,490
010956593,2024-10-27T15:41:23,500,10,BANCO,0002,,490
010959555,2024-10-27T15:42:02,500,10,BANCO,0002,,490
010954087,2024-10-27T15:41:22,1000,20,BANCO,0005,,980
010961094,2024-10-27T15:45:42,500,10,BANCO,0002,,490
010901974,2024-10-27T15:46:59,140,3,BANCO,0002,,137
010932591,2024-10-27T15:47:20,150,3,BANCO,0002,,147
010939339,2024-10-27T15:47:42,1000,20,BANCO,0002,,980
010942683,2024-10-27T15:47:51,1000,20,BANCO,0002,,980
010947498,2024-10-27T15:48:09,150,3,BANCO,0002,,147
010949479,2024-10-27T15:48:39,500,10,BANCO,0002,,490
010920921,2024-10-27T15:49:10,100,2,BANCO,0002,,98
010932129,2024-10-27T15:49:22,250,5,BANCO,0002,,245
010945634,2024-10-27T15:50:04,80,2,BANCO,0002,,78
010954624,2024-10-27T15:50:15,500,10,BANCO,0002,,490
010961713,2024-10-27T15:52:51,1000,20,BANCO,0002,,980
010961111,2024-10-27T15:52:52,50,1,BANCO,0002,,49
010961082,2024-10-27T15:53:00,500,10,BANCO,0002,,490
010960699,2024-10-27T15:54:18,200,4,BANCO,0002,,196
010962089,2024-10-27T15:54:19,200,4,BANCO,0002,,196
010922544,2024-10-27T15:55:14,150,3,BANCO,0002,,147
010926480,2024-10-27T15:55:17,500,10,BANCO,0002,,490
010931663,2024-10-27T15:55:28,150,3,BANCO,0002,,147
010937616,2024-10-27T15:55:38,404,8,BANCO,0008,,396
010939440,2024-10-27T15:55:45,260,5,BANCO,0002,,255
010944944,2024-10-27T15:56:11,900,18,BANCO,0002,,882
010948146,2024-10-27T15:56:42,200,4,BANCO,0002,,196
010948194,2024-10-27T15:56:46,200,4,BANCO,0002,,196
010951380,2024-10-27T15:59:18,600,12,BANCO,0002,,588
010954597,2024-10-27T15:59:29,100,2,BANCO,0002,,98
010953342,2024-10-27T16:00:01,50,1,BANCO,0002,,49
010957905,2024-10-27T16:01:58,250,5,BANCO,0002,,245
010958976,2024-10-27T16:02:14,500,10,BANCO,0008,,490
010959626,2024-10-27T16:02:19,1000,20,BANCO,0002,,980
010901214,2024-10-27T16:02:51,1000,20,BANCO,0002,,980
010911842,2024-10-27T16:02:55,500,10,BANCO,0004,,490
010932683,2024-10-27T16:03:37,500,10,BANCO,0002,,490
010938924,2024-10-27T16:03:48,500,10,BANCO,0002,,490
010944121,2024-10-27T16:03:48,150,3,BANCO,0002,,147
010944342,2024-10-27T16:03:49,150,3,BANCO,0002,,147
010947048,2024-10-27T16:04:31,150,3,BANCO,0008,,147
010947207,2024-10-27T17:05:12,500,10,BANCO,0011,,490
010947504,2024-10-27T16:05:17,500,10,BANCO,0004,,490
010956235,2024-10-27T16:06:02,150,3,BANCO,0002,,147
010957957,2024-10-27T16:06:52,200,4,BANCO,0002,,196
010959561,2024-10-27T16:07:59,600,12,BANCO,0004,,588
010962190,2024-10-27T16:08:38,250,5,BANCO,0002,,245
010879348,2024-10-27T16:09:05,500,10,BANCO,0002,,490
010910290,2024-10-27T16:09:10,100,2,BANCO,0008,,98
010949695,2024-10-27T16:10:52,150,3,BANCO,0004,,147
010953638,2024-10-27T16:11:10,1000,20,BANCO,0008,,980
010956311,2024-10-27T16:11:41,700,14,BANCO,0002,,686
010902623,2024-10-27T16:13:13,1000,20,BANCO,0002,,980
010952144,2024-10-27T16:14:39,250,5,BANCO,0002,,245
010955176,2024-10-27T16:15:10,150,3,BANCO,0002,,147
010958632,2024-10-27T16:15:35,500,10,BANCO,0008,,490
010849951,2024-10-27T16:17:24,500,10,BANCO,0002,,490
010913537,2024-10-27T16:17:37,1000,20,BANCO,0002,,980
010921901,2024-10-27T16:17:58,150,3,BANCO,0002,,147
010932919,2024-10-27T16:18:02,50,1,BANCO,0002,,49
010948558,2024-10-27T16:16:16,500,10,BANCO,0005,,490
010951744,2024-10-27T16:19:00,510,10,BANCO,0002,,500
010951152,2024-10-27T16:19:05,500,10,BANCO,0008,,490
010957835,2024-10-27T16:19:37,500,10,BANCO,0002,,490
010959649,2024-10-27T16:19:41,100,2,BANCO,0002,,98
010938288,2024-10-27T16:20:22,300,6,BANCO,0002,,294
010942183,2024-10-27T16:21:00,250,5,BANCO,0004,,245
010951740,2024-10-27T16:21:14,150,3,BANCO,0002,,147
010960512,2024-10-27T16:23:32,1500,30,BANCO,0002,,1470
010896552,2024-10-27T16:24:18,50,1,BANCO,0002,,49
010918842,2024-10-27T16:24:58,1000,20,BANCO,0002,,980
010920828,2024-10-27T16:25:42,500,10,BANCO,0002,,490
010939873,2024-10-27T16:26:15,350,7,BANCO,0002,,343
010947357,2024-10-27T16:27:44,500,10,BANCO,0002,,490
010949259,2024-10-27T16:28:28,500,10,BANCO,0002,,490
010956835,2024-10-27T16:29:33,500,10,BANCO,0004,,490
010960515,2024-10-27T16:29:57,1000,20,BANCO,0002,,980
010897027,2024-10-27T16:31:21,250,5,BANCO,0002,,245
010915265,2024-10-27T16:31:43,500,10,BANCO,0002,,490
010928761,2024-10-27T16:32:13,500,10,BANCO,0002,,490
010931604,2024-10-27T16:32:18,100,2,BANCO,0002,,98
010935514,2024-10-27T16:30:09,700,14,BANCO,0005,,686
010894228,2024-10-27T16:33:59,1000,20,BANCO,0002,,980
010922178,2024-10-27T16:31:47,200,4,BANCO,0005,,196
010929478,2024-10-27T16:34:04,500,10,BANCO,0002,,490
010936618,2024-10-27T16:34:12,1000,20,BANCO,0002,,980
010948520,2024-10-27T16:33:03,1000,20,BANCO,0005,,980
010948158,2024-10-27T16:36:41,500,10,BANCO,0002,,490
010951222,2024-10-27T16:37:06,500,10,BANCO,0002,,490
010952453,2024-10-27T16:39:12,250,5,BANCO,0002,,245
010952305,2024-10-27T16:38:56,250,5,BANCO,0005,,245
010952380,2024-10-27T16:41:12,500,10,BANCO,0002,,490
010959407,2024-10-27T16:41:50,250,5,BANCO,0002,,245
010962342,2024-10-27T16:41:59,50,1,BANCO,0002,,49
010962333,2024-10-27T16:42:09,500,10,BANCO,0002,,490
010938171,2024-10-27T16:43:20,500,10,BANCO,0002,,490
010941388,2024-10-27T16:43:45,500,10,BANCO,0002,,490
010948177,2024-10-27T16:44:17,150,3,BANCO,0002,,147
010956397,2024-10-27T16:45:08,150,3,BANCO,0002,,147
010929188,2024-10-27T16:46:25,500,10,BANCO,0002,,490
010933885,2024-10-27T16:46:29,500,10,BANCO,0002,,490
010943972,2024-10-27T16:49:03,500,10,BANCO,0008,,490
010945240,2024-10-27T16:49:23,500,10,BANCO,0002,,490
010927847,2024-10-27T16:51:44,100,2,BANCO,0002,,98
010937489,2024-10-27T16:49:42,200,4,BANCO,0005,,196
010948781,2024-10-27T16:53:14,150,3,BANCO,0002,,147
010954709,2024-10-27T16:54:21,150,3,BANCO,0002,,147
010957923,2024-10-27T16:54:46,250,5,BANCO,0004,,245
010958368,2024-10-27T16:54:53,100,2,BANCO,0002,,98
010957874,2024-10-27T16:54:59,1000,20,BANCO,0002,,980
010960529,2024-10-27T16:52:50,1000,20,BANCO,0005,,980
010903151,2024-10-27T16:55:19,500,10,BANCO,0002,,490
010919298,2024-10-27T16:56:06,150,3,BANCO,0002,,147
010926157,2024-10-27T17:56:35,2500,50,BANCO,0011,,2450
010928943,2024-10-27T16:57:07,500,10,BANCO,0002,,490
010939860,2024-10-27T16:57:52,550,11,BANCO,0002,,539
010940963,2024-10-27T16:58:01,200,4,BANCO,0002,,196
010950437,2024-10-27T16:58:13,200,4,BANCO,0002,,196
010917135,2024-10-27T17:01:31,350,7,BANCO,0002,,343
010938770,2024-10-27T17:02:36,150,3,BANCO,0002,,147
010940276,2024-10-27T17:00:55,500,10,BANCO,0005,,490
010954697,2024-10-27T17:04:04,200,4,BANCO,0002,,196
010954669,2024-10-27T17:04:24,500,10,BANCO,0002,,490
010954429,2024-10-27T17:02:17,1000,20,BANCO,0005,,980
010962344,2024-10-27T17:07:18,1000,20,BANCO,0002,,980
010929811,2024-10-27T17:06:47,150,3,BANCO,0005,,147
010942758,2024-10-27T17:10:37,500,10,BANCO,0002,,490
010951070,2024-10-27T17:11:37,500,10,BANCO,0002,,490
010953013,2024-10-27T17:09:37,1000,20,BANCO,0005,,980
010960800,2024-10-27T17:12:24,150,3,BANCO,0002,,147
010905006,2024-10-27T17:13:03,500,10,BANCO,0002,,490
010913463,2024-10-27T17:13:18,300,6,BANCO,0002,,294
010932531,2024-10-27T17:13:32,1000,20,BANCO,0002,,980
010935267,2024-10-27T17:13:49,150,3,BANCO,0002,,147
010941670,2024-10-27T17:13:59,150,3,BANCO,0002,,147
010946231,2024-10-27T17:11:54,100,2,BANCO,0005,,98
010945885,2024-10-27T17:14:09,500,10,BANCO,0002,,490
010949461,2024-10-27T17:14:48,500,10,BANCO,0002,,490
010949842,2024-10-27T17:15:00,700,14,BANCO,0002,,686
010955750,2024-10-27T17:15:24,150,3,BANCO,0002,,147
010956085,2024-10-27T17:15:34,350,7,BANCO,0002,,343
010930048,2024-10-27T17:16:13,1000,20,BANCO,0002,,980
010946169,2024-10-27T17:17:31,50,1,BANCO,0002,,49
010956561,2024-10-27T17:18:48,250,5,BANCO,0002,,245
010962635,2024-10-27T17:19:21,200,4,BANCO,0002,,196
010937544,2024-10-27T17:21:09,500,10,BANCO,0002,,490
010940570,2024-10-27T17:21:32,250,5,BANCO,0002,,245
010944217,2024-10-27T17:21:36,150,3,BANCO,0002,,147
010947709,2024-10-27T17:23:16,180,4,BANCO,0002,,176
010959673,2024-10-27T17:24:20,50,1,BANCO,0002,,49
010959791,2024-10-27T17:24:20,500,10,BANCO,0004,,490
010910457,2024-10-27T17:25:29,50,1,BANCO,0002,,49
010915179,2024-10-27T17:25:36,50,1,BANCO,0002,,49
010928505,2024-10-27T17:25:46,500,10,BANCO,0002,,490
010929718,2024-10-27T17:25:55,150,3,BANCO,0002,,147
010932000,2024-10-27T17:26:56,250,5,BANCO,0002,,245
010955954,2024-10-27T17:27:36,150,3,BANCO,0002,,147
010956534,2024-10-27T17:28:37,110,2,BANCO,0002,,108
010958766,2024-10-27T17:29:04,250,5,BANCO,0002,,245
010960496,2024-10-27T17:31:51,250,5,BANCO,0002,,245
010962594,2024-10-27T17:34:13,500,10,BANCO,0002,,490
010893048,2024-10-27T17:35:07,1000,20,BANCO,0002,,980
010925200,2024-10-27T17:35:49,500,10,BANCO,0002,,490
010938458,2024-10-27T17:36:45,50,1,BANCO,0002,,49
010938379,2024-10-27T17:36:47,1000,20,BANCO,0002,,980
010947336,2024-10-27T17:37:05,60,1,BANCO,0002,,59
010951910,2024-10-27T17:37:22,250,5,BANCO,0002,,245
010954523,2024-10-27T17:38:52,2500,50,BANCO,0002,,2450
010962320,2024-10-27T17:41:02,500,10,BANCO,0002,,490
010892806,2024-10-27T17:41:16,250,5,BANCO,0002,,245
010919984,2024-10-27T17:41:20,150,3,BANCO,0002,,147
010926076,2024-10-27T17:41:40,150,3,BANCO,0002,,147
010941992,2024-10-27T17:40:32,1100,22,BANCO,0005,,1078
010949702,2024-10-27T17:42:45,200,4,BANCO,0002,,196
010950921,2024-10-27T17:43:24,300,6,BANCO,0002,,294
010955774,2024-10-27T17:45:16,500,10,BANCO,0002,,490
010961878,2024-10-27T17:44:05,500,10,BANCO,0005,,490
010961416,2024-10-27T17:46:53,500,10,BANCO,0002,,490
010962548,2024-10-27T17:46:53,50,1,BANCO,0002,,49
010962184,2024-10-27T17:47:38,610,12,BANCO,0002,,598
010891058,2024-10-27T17:48:40,500,10,BANCO,0002,,490
010917368,2024-10-27T17:48:50,500,10,BANCO,0004,,490
010929227,2024-10-27T17:49:21,1000,20,BANCO,0002,,980
010930251,2024-10-27T17:49:24,150,3,BANCO,0002,,147
010936202,2024-10-27T17:49:31,1000,20,BANCO,0002,,980
010939668,2024-10-27T17:49:52,200,4,BANCO,0002,,196
010943021,2024-10-27T17:50:48,1000,20,BANCO,0002,,980
010945364,2024-10-27T17:50:49,500,10,BANCO,0004,,490
010945723,2024-10-27T17:50:49,150,3,BANCO,0002,,147
010951484,2024-10-27T17:53:50,100,2,BANCO,0002,,98
010957728,2024-10-27T17:54:30,610,12,BANCO,0002,,598
010959191,2024-10-27T17:54:51,250,5,BANCO,0004,,245
010958964,2024-10-27T17:55:07,150,3,BANCO,0002,,147
010961728,2024-10-27T17:55:12,200,4,BANCO,0002,,196
010897936,2024-10-27T17:55:32,250,5,BANCO,0002,,245
010925502,2024-10-27T17:56:44,150,3,BANCO,0002,,147
010926418,2024-10-27T17:56:52,300,6,BANCO,0004,,294
010933949,2024-10-27T17:57:00,250,5,BANCO,0002,,245
010953019,2024-10-27T17:56:09,1000,20,BANCO,0005,,980
010953856,2024-10-27T17:58:46,250,5,BANCO,0002,,245
010954754,2024-10-27T17:59:04,250,5,BANCO,0002,,245
010958258,2024-10-27T17:59:35,500,10,BANCO,0002,,490
010960410,2024-10-27T18:00:21,1000,20,BANCO,0002,,980
010960477,2024-10-27T18:00:51,500,10,BANCO,0004,,490
010917590,2024-10-27T18:01:04,200,4,BANCO,0002,,196
010947146,2024-10-27T18:00:15,1000,20,BANCO,0005,,980
010954124,2024-10-27T18:04:06,50,1,BANCO,0004,,49
010958959,2024-10-27T18:04:27,150,3,BANCO,0002,,147
010960980,2024-10-27T18:04:43,1000,20,BANCO,0002,,980
010892857,2024-10-27T18:02:31,500,10,BANCO,0005,,490
010914291,2024-10-27T18:05:05,200,4,BANCO,0002,,196
010918943,2024-10-27T18:05:11,150,3,BANCO,0002,,147
010931160,2024-10-27T18:05:37,1000,20,BANCO,0002,,980
010951334,2024-10-27T18:05:51,150,3,BANCO,0002,,147
010958510,2024-10-27T18:04:59,500,10,BANCO,0005,,490
010882219,2024-10-27T18:07:34,200,4,BANCO,0002,,196
010946286,2024-10-27T18:08:01,1000,20,BANCO,0002,,980
010946920,2024-10-27T18:08:37,150,3,BANCO,0002,,147
010951030,2024-10-27T18:10:14,150,3,BANCO,0002,,147
010952169,2024-10-27T18:11:03,1000,20,BANCO,0002,,980
010928980,2024-10-27T18:11:58,500,10,BANCO,0002,,490
010937557,2024-10-27T18:12:31,500,10,BANCO,0002,,490
010939536,2024-10-27T18:12:52,50,1,BANCO,0002,,49
010942523,2024-10-27T18:13:03,500,10,BANCO,0002,,490
010954675,2024-10-27T18:13:29,1000,20,BANCO,0004,,980
010955868,2024-10-27T18:14:09,200,4,BANCO,0002,,196
010960027,2024-10-27T18:14:45,250,5,BANCO,0002,,245
010961544,2024-10-27T18:13:03,300,6,BANCO,0005,,294
010943214,2024-10-27T18:14:00,1000,20,BANCO,0005,,980
010944779,2024-10-27T18:14:01,500,10,BANCO,0005,,490
010949250,2024-10-27T18:16:32,250,5,BANCO,0002,,245
010954334,2024-10-27T18:16:46,600,12,BANCO,0002,,588
010953368,2024-10-27T18:18:18,500,10,BANCO,0002,,490
010960180,2024-10-27T18:18:45,500,10,BANCO,0004,,490
010960177,2024-10-27T18:18:49,500,10,BANCO,0002,,490
010959073,2024-10-27T18:17:40,500,10,BANCO,0005,,490
010961629,2024-10-27T18:20:34,250,5,BANCO,0002,,245
010960936,2024-10-27T18:21:15,1000,20,BANCO,0002,,980
010962756,2024-10-27T18:21:30,260,5,BANCO,0002,,255
010891391,2024-10-27T18:22:20,500,10,BANCO,0008,,490
010940306,2024-10-27T18:24:04,160,3,BANCO,0002,,157
010943595,2024-10-27T18:24:05,200,4,BANCO,0002,,196
010955778,2024-10-27T18:25:05,250,5,BANCO,0002,,245
010957027,2024-10-27T18:25:15,1000,20,BANCO,0008,,980
010956217,2024-10-27T18:25:44,500,10,BANCO,0002,,490
010958615,2024-10-27T18:25:59,200,4,BANCO,0004,,196
010958979,2024-10-27T18:26:01,60,1,BANCO,0002,,59
010959382,2024-10-27T18:26:31,500,10,BANCO,0002,,490
010892795,2024-10-27T18:26:35,250,5,BANCO,0004,,245
010831299,2024-10-27T18:27:01,500,10,BANCO,0002,,490
010944185,2024-10-27T18:27:51,100,2,BANCO,0002,,98
010946543,2024-10-27T18:28:00,220,4,BANCO,0002,,216
010954988,2024-10-27T18:27:57,300,6,BANCO,0005,,294
010924564,2024-10-27T18:33:56,522,10,BANCO,0002,,512
010926916,2024-10-27T18:33:59,250,5,BANCO,0002,,245
010930673,2024-10-27T18:34:13,500,10,BANCO,0002,,490
010936885,2024-10-27T18:34:36,350,7,BANCO,0002,,343
010905239,2024-10-27T18:35:42,250,5,BANCO,0002,,245
010928844,2024-10-27T18:35:56,500,10,BANCO,0002,,490
010941514,2024-10-27T18:36:53,300,6,BANCO,0002,,294
010946087,2024-10-27T18:37:11,610,12,BANCO,0002,,598
010959689,2024-10-27T18:38:27,500,10,BANCO,0002,,490
010896862,2024-10-27T18:38:41,500,10,BANCO,0002,,490
010925165,2024-10-27T18:39:02,150,3,BANCO,0002,,147
010945906,2024-10-27T18:39:31,1000,20,BANCO,0004,,980
010945161,2024-10-27T18:41:07,1000,20,BANCO,0002,,980
010948192,2024-10-27T18:42:17,50,1,BANCO,0002,,49
010950313,2024-10-27T18:42:34,1000,20,BANCO,0008,,980
010952418,2024-10-27T18:42:43,100,2,BANCO,0002,,98
010956425,2024-10-27T18:43:11,550,11,BANCO,0002,,539
010956586,2024-10-27T18:43:36,150,3,BANCO,0002,,147
010960209,2024-10-27T18:45:58,150,3,BANCO,0002,,147
010959211,2024-10-27T18:46:16,500,10,BANCO,0002,,490
010872944,2024-10-27T18:46:44,500,10,BANCO,0002,,490
010838326,2024-10-27T18:46:57,300,6,BANCO,0002,,294
010946217,2024-10-27T18:48:48,150,3,BANCO,0002,,147
010948364,2024-10-27T18:49:17,1000,20,BANCO,0002,,980
010952875,2024-10-27T18:49:23,260,5,BANCO,0002,,255
010952748,2024-10-27T18:49:35,500,10,BANCO,0002,,490
010962243,2024-10-27T18:50:06,100,2,BANCO,0008,,98
010962318,2024-10-27T18:50:57,1000,20,BANCO,0002,,980
010912393,2024-10-27T18:51:24,1000,20,BANCO,0002,,980
010944404,2024-10-27T18:53:22,300,6,BANCO,0002,,294
010943585,2024-10-27T18:54:00,600,12,BANCO,0002,,588
010946193,2024-10-27T18:54:04,270,5,BANCO,0002,,265
010948333,2024-10-27T18:54:39,1000,20,BANCO,0002,,980
010951151,2024-10-27T18:54:48,200,4,BANCO,0002,,196
010952823,2024-10-27T18:55:06,1080,22,BANCO,0002,,1058
010953226,2024-10-27T18:55:43,150,3,BANCO,0002,,147
010959507,2024-10-27T18:56:23,500,10,BANCO,0002,,490
010960942,2024-10-27T18:54:58,500,10,BANCO,0005,,490
010960884,2024-10-27T18:58:00,560,11,BANCO,0002,,549
010872516,2024-10-27T18:58:06,290,6,BANCO,0002,,284
010935127,2024-10-27T18:58:56,150,3,BANCO,0002,,147
010945961,2024-10-27T19:00:06,250,5,BANCO,0002,,245
010959435,2024-10-27T19:00:45,1000,20,BANCO,0002,,980
010944626,2024-10-27T18:59:26,1000,20,BANCO,0005,,980
010954048,2024-10-27T19:01:49,250,5,BANCO,0004,,245
010955690,2024-10-27T19:01:59,150,3,BANCO,0002,,147
010954975,2024-10-27T19:00:36,500,10,BANCO,0005,,490
010955799,2024-10-27T19:03:16,500,10,BANCO,0002,,490
010955569,2024-10-27T19:03:19,500,10,BANCO,0002,,490
010958571,2024-10-27T19:04:10,250,5,BANCO,0002,,245
010959640,2024-10-27T19:04:11,500,10,BANCO,0008,,490
010959093,2024-10-27T19:02:01,1000,20,BANCO,0005,,980
010960156,2024-10-27T19:05:10,250,5,BANCO,0002,,245
010959406,2024-10-27T19:05:24,500,10,BANCO,0002,,490
010960158,2024-10-27T19:05:28,50,1,BANCO,0002,,49
010959798,2024-10-27T19:05:39,500,10,BANCO,0002,,490
010962336,2024-10-27T19:05:44,1000,20,BANCO,0002,,980
010966885,2024-10-27T19:06:53,260,5,BANCO,0002,,255
010966120,2024-10-27T19:06:54,100,2,BANCO,0002,,98
010966145,2024-10-27T19:05:03,1000,20,BANCO,0005,,980
010966958,2024-10-27T19:05:29,300,6,BANCO,0005,,294
010966080,2024-10-27T19:05:44,250,5,BANCO,0005,,245
010966337,2024-10-27T19:08:12,300,6,BANCO,0002,,294
010966538,2024-10-27T19:08:36,250,5,BANCO,0002,,245
010966674,2024-10-27T19:08:54,500,10,BANCO,0002,,490
010966416,2024-10-27T19:09:06,1000,20,BANCO,0002,,980
010966284,2024-10-27T19:09:50,500,10,BANCO,0002,,490
010968200,2024-10-27T19:11:07,500,10,BANCO,0002,,490
010967583,2024-10-27T19:11:10,500,10,BANCO,0002,,490
010968444,2024-10-27T19:11:12,1000,20,BANCO,0002,,980
010969224,2024-10-27T19:12:15,100,2,BANCO,0002,,98
010970442,2024-10-27T19:12:41,500,10,BANCO,0002,,490
010932401,2024-10-27T19:12:22,150,3,BANCO,0005,,147
010939490,2024-10-27T19:14:44,500,10,BANCO,0002,,490
010944666,2024-10-27T19:14:47,500,10,BANCO,0002,,490
010957508,2024-10-27T19:15:02,500,10,BANCO,0005,,490
010962383,2024-10-27T19:18:23,150,3,BANCO,0002,,147
010964112,2024-10-27T19:17:49,500,10,BANCO,0005,,490
010963553,2024-10-27T19:20:54,500,10,BANCO,0002,,490
010966355,2024-10-27T19:22:27,200,4,BANCO,0002,,196
010966435,2024-10-27T19:23:59,150,3,BANCO,0002,,147
010967240,2024-10-27T19:24:48,500,10,BANCO,0002,,490
010966796,2024-10-27T19:23:03,500,10,BANCO,0005,,490
010968767,2024-10-27T19:26:16,500,10,BANCO,0002,,490
010969938,2024-10-27T19:27:05,150,3,BANCO,0002,,147
010921349,2024-10-27T19:27:53,500,10,BANCO,0002,,490
010946270,2024-10-27T19:28:30,250,5,BANCO,0002,,245
010951940,2024-10-27T19:29:24,150,3,BANCO,0002,,147
010957154,2024-10-27T19:30:26,100,2,BANCO,0002,,98
010958568,2024-10-27T19:31:12,1000,20,BANCO,0002,,980
010961311,2024-10-27T19:31:36,1000,20,BANCO,0002,,980
010962313,2024-10-27T19:32:11,500,10,BANCO,0002,,490
010963425,2024-10-27T19:32:19,1000,20,BANCO,0002,,980
010965383,2024-10-27T19:30:25,250,5,BANCO,0005,,245
010969151,2024-10-27T19:32:59,210,4,BANCO,0002,,206
010850237,2024-10-27T19:34:06,1000,20,BANCO,0004,,980
010904571,2024-10-27T19:34:52,500,10,BANCO,0004,,490
010934271,2024-10-27T19:35:46,310,6,BANCO,0004,,304
010956575,2024-10-27T19:38:31,110,2,BANCO,0005,,108
010956032,2024-10-27T19:43:28,1000,20,BANCO,0003,,980
010960449,2024-10-27T19:43:51,400,8,BANCO,0003,,392
010959088,2024-10-27T19:44:02,500,10,BANCO,0003,,490
010959072,2024-10-27T19:44:10,250,5,BANCO,0003,,245
010959973,2024-10-27T19:44:13,1000,20,BANCO,0003,,980
010959687,2024-10-27T19:44:15,400,8,BANCO,0003,,392
010963916,2024-10-27T19:45:20,150,3,BANCO,0003,,147
010964171,2024-10-27T19:45:23,500,10,BANCO,0003,,490
010967654,2024-10-27T19:47:26,3000,60,BANCO,0003,,2940
010969012,2024-10-27T19:47:31,500,10,BANCO,0003,,490
010968953,2024-10-27T19:48:13,250,5,BANCO,0003,,245
010969156,2024-10-27T19:48:44,1000,20,BANCO,0003,,980
010969176,2024-10-27T19:49:02,500,10,BANCO,0003,,490
010969448,2024-10-27T19:49:09,1000,20,BANCO,0003,,980
010969606,2024-10-27T19:49:09,250,5,BANCO,0003,,245
010969832,2024-10-27T19:49:30,500,10,BANCO,0003,,490
010871929,2024-10-27T19:47:18,500,10,BANCO,0005,,490
010882071,2024-10-27T19:49:59,1000,20,BANCO,0003,,980
010949680,2024-10-27T19:52:07,1000,20,BANCO,0003,,980
010956735,2024-10-27T19:53:07,150,3,BANCO,0003,,147
010956009,2024-10-27T19:53:20,500,10,BANCO,0003,,490
010961213,2024-10-27T19:54:23,1000,20,BANCO,0003,,980
010962145,2024-10-27T19:54:33,100,2,BANCO,0003,,98
010965740,2024-10-27T19:54:20,300,6,BANCO,0008,,294
010964681,2024-10-27T19:54:58,250,5,BANCO,0003,,245
010969272,2024-10-27T19:56:01,500,10,BANCO,0003,,490
010970382,2024-10-27T19:56:24,100,2,BANCO,0003,,98
010918558,2024-10-27T19:56:54,1000,20,BANCO,0003,,980
010928180,2024-10-27T19:57:02,1000,20,BANCO,0003,,980
010930476,2024-10-27T19:57:06,500,10,BANCO,0003,,490
010956746,2024-10-27T19:58:28,260,5,BANCO,0003,,255
010963142,2024-10-27T20:01:09,1000,20,BANCO,0003,,980
010963426,2024-10-27T20:01:01,150,3,BANCO,0008,,147
010966407,2024-10-27T20:02:04,250,5,BANCO,0003,,245
010967374,2024-10-27T20:00:08,150,3,BANCO,0005,,147
010966153,2024-10-27T20:03:35,500,10,BANCO,0003,,490
010966403,2024-10-27T20:04:09,500,10,BANCO,0003,,490
010967772,2024-10-27T20:06:17,700,14,BANCO,0003,,686
010967839,2024-10-27T20:06:24,500,10,BANCO,0003,,490
010882398,2024-10-27T20:06:24,200,4,BANCO,0003,,196
010928051,2024-10-27T20:07:46,1000,20,BANCO,0003,,980
010937344,2024-10-27T20:08:48,250,5,BANCO,0003,,245
010941618,2024-10-27T20:11:20,1000,20,BANCO,0003,,980
010954707,2024-10-27T20:11:26,50,1,BANCO,0003,,49
010958417,2024-10-27T20:14:02,500,10,BANCO,0003,,490
010961071,2024-10-27T20:11:56,500,10,BANCO,0005,,490
010964235,2024-10-27T20:14:43,150,3,BANCO,0003,,147
010963809,2024-10-27T20:15:04,500,10,BANCO,0003,,490
010963078,2024-10-27T20:15:05,250,5,BANCO,0003,,245
010966315,2024-10-27T20:16:53,500,10,BANCO,0003,,490
010966510,2024-10-27T20:14:26,150,3,BANCO,0005,,147
010966897,2024-10-27T20:17:12,500,10,BANCO,0003,,490
010905424,2024-10-27T20:18:53,250,5,BANCO,0003,,245
010927071,2024-10-27T20:20:21,190,4,BANCO,0003,,186
010940037,2024-10-27T20:22:11,200,4,BANCO,0003,,196
010950208,2024-10-27T20:25:06,300,6,BANCO,0003,,294
010952140,2024-10-27T20:23:44,250,5,BANCO,0005,,245
010953594,2024-10-27T20:30:24,250,5,BANCO,0003,,245
010955585,2024-10-27T20:31:52,1000,20,BANCO,0003,,980
010954971,2024-10-27T20:32:16,1000,20,BANCO,0003,,980
010959008,2024-10-27T20:33:09,500,10,BANCO,0003,,490
010963189,2024-10-27T20:33:28,500,10,BANCO,0003,,490
010964057,2024-10-27T20:33:48,200,4,BANCO,0003,,196
010963091,2024-10-27T20:35:19,250,5,BANCO,0003,,245
010963114,2024-10-27T20:35:03,500,10,BANCO,0004,,490
010964423,2024-10-27T20:35:24,1000,20,BANCO,0003,,980
010963743,2024-10-27T20:35:59,500,10,BANCO,0003,,490
010963726,2024-10-27T20:36:16,500,10,BANCO,0003,,490
010965979,2024-10-27T20:36:20,50,1,BANCO,0003,,49
010965770,2024-10-27T20:36:55,1000,20,BANCO,0003,,980
010964606,2024-10-27T20:39:01,500,10,BANCO,0008,,490
010966331,2024-10-27T20:39:38,150,3,BANCO,0003,,147
010966610,2024-10-27T20:40:13,100,2,BANCO,0003,,98
010969173,2024-10-27T20:40:18,150,3,BANCO,0004,,147
010910470,2024-10-27T20:41:08,500,10,BANCO,0003,,490
010923202,2024-10-27T20:43:08,200,4,BANCO,0003,,196
010951063,2024-10-27T20:44:54,1000,20,BANCO,0003,,980
010950847,2024-10-27T20:45:14,200,4,BANCO,0003,,196
010959298,2024-10-27T20:45:59,578,12,BANCO,0003,,566
010964020,2024-10-27T20:46:43,1000,20,BANCO,0003,,980
010965674,2024-10-27T20:47:17,250,5,BANCO,0003,,245
010965884,2024-10-27T20:47:32,250,5,BANCO,0003,,245
010965460,2024-10-27T20:49:03,150,3,BANCO,0003,,147
010964633,2024-10-27T20:49:05,500,10,BANCO,0003,,490
010966838,2024-10-27T20:49:53,1000,20,BANCO,0003,,980
010966047,2024-10-27T20:53:46,1000,20,BANCO,0003,,980
010967795,2024-10-27T20:54:39,500,10,BANCO,0008,,490
010968974,2024-10-27T20:55:00,500,10,BANCO,0003,,490
010968022,2024-10-27T20:55:32,500,10,BANCO,0003,,490
010905552,2024-10-27T20:57:24,1000,20,BANCO,0003,,980
010906432,2024-10-27T20:57:31,500,10,BANCO,0003,,490
010941975,2024-10-27T20:58:03,1000,20,BANCO,0003,,980
010944784,2024-10-27T20:58:35,1000,20,BANCO,0003,,980
010958810,2024-10-27T21:02:11,50,1,BANCO,0003,,49
010959854,2024-10-27T21:03:44,500,10,BANCO,0004,,490
010963724,2024-10-27T21:06:07,300,6,BANCO,0003,,294
010963410,2024-10-27T21:06:21,250,5,BANCO,0003,,245
010895922,2024-10-27T21:10:51,250,5,BANCO,0003,,245
010896537,2024-10-27T21:11:03,150,3,BANCO,0003,,147
010945941,2024-10-27T21:12:41,150,3,BANCO,0003,,147
010949654,2024-10-27T21:14:45,1000,20,BANCO,0003,,980
010956902,2024-10-27T21:19:42,1100,22,BANCO,0003,,1078
010963957,2024-10-27T21:25:57,500,10,BANCO,0003,,490
010963681,2024-10-27T21:23:22,150,3,BANCO,0005,,147
010965564,2024-10-27T21:26:52,200,4,BANCO,0003,,196
010964761,2024-10-27T21:27:33,500,10,BANCO,0003,,490
010965505,2024-10-27T21:27:35,250,5,BANCO,0003,,245
010970089,2024-10-27T21:27:36,100,2,BANCO,0003,,98
010969273,2024-10-27T21:27:48,1000,20,BANCO,0003,,980
010868497,2024-10-27T21:28:56,1000,20,BANCO,0003,,980
010912537,2024-10-27T21:30:49,250,5,BANCO,0003,,245
010944869,2024-10-27T21:33:53,500,10,BANCO,0003,,490
010957631,2024-10-27T21:37:46,500,10,BANCO,0003,,490
010957610,2024-10-27T21:39:34,500,10,BANCO,0003,,490
010966847,2024-10-27T21:43:09,510,10,BANCO,0003,,500
010968184,2024-10-27T21:43:15,1000,20,BANCO,0003,,980
010968149,2024-10-27T21:43:26,1000,20,BANCO,0003,,980
010825395,2024-10-27T21:44:10,500,10,BANCO,0003,,490
010834887,2024-10-27T21:45:03,500,10,BANCO,0003,,490
010915694,2024-10-27T21:45:14,250,5,BANCO,0003,,245
010943060,2024-10-27T21:46:19,250,5,BANCO,0003,,245
010952455,2024-10-27T21:49:17,150,3,BANCO,0003,,147
010955576,2024-10-27T21:48:58,89,2,BANCO,0008,,87
010963075,2024-10-27T21:53:18,500,10,BANCO,0003,,490
010963248,2024-10-27T21:54:10,2000,40,BANCO,0003,,1960
010964043,2024-10-27T21:51:55,800,16,BANCO,0005,,784
010965171,2024-10-27T21:55:06,1000,20,BANCO,0003,,980
010967837,2024-10-27T21:57:07,500,10,BANCO,0003,,490
010968702,2024-10-27T21:59:19,150,3,BANCO,0003,,147
010968492,2024-10-27T21:59:28,490,10,BANCO,0003,,480
010967888,2024-10-27T21:57:07,60,1,BANCO,0005,,59
010969424,2024-10-27T22:01:31,500,10,BANCO,0003,,490
010969428,2024-10-27T22:01:42,200,4,BANCO,0004,,196
010969394,2024-10-27T22:02:06,150,3,BANCO,0003,,147
010885735,2024-10-27T22:06:57,500,10,BANCO,0003,,490
010909940,2024-10-27T22:07:45,1000,20,BANCO,0003,,980
010914240,2024-10-27T22:05:29,150,3,BANCO,0005,,147
010925423,2024-10-27T22:10:28,300,6,BANCO,0003,,294
010925229,2024-10-27T22:11:39,500,10,BANCO,0003,,490
010933577,2024-10-27T22:11:42,500,10,BANCO,0003,,490
010959706,2024-10-27T22:15:49,1000,20,BANCO,0003,,980
010959787,2024-10-27T22:17:11,600,12,BANCO,0003,,588
010967365,2024-10-27T22:25:05,500,10,BANCO,0004,,490
010885938,2024-10-27T22:28:22,2000,40,BANCO,0008,,1960
010965061,2024-10-27T22:40:53,200,4,BANCO,0004,,196
010966783,2024-10-27T23:03:28,250,5,BANCO,0008,,245
010968285,2024-10-27T23:15:47,150,3,BANCO,0004,,147
010970390,2024-10-27T23:20:56,501,10,BANCO,0008,,491
010969282,2024-10-27T23:22:09,260,5,BANCO,0004,,255
